Id	Text	Sentiment
abduction	अपहरण;शरीरको मध्य भाग देखी टाढा लिने कृया;अपहरण(m);अपवर्तन(m);धोका दिएर जानु;फकाएर वा धम्काएर भगाउनु;बलात्कार हरण;लैजानु	-1
abhorrent	घिनलाग्दो;घृणास्पद;घृणित;निन्दनीय;बीभत्स;को विरोधी	-1
absolved	दोषमुक्त;मुक्त	1
abstinent	बार्ने व्यक्ति;मद्य-त्यागी (m);मिताहारी (m);फारो गर्ने व्यक्ति;संयमी	-1
abuse	अपमान गर्नु;दुर्वचन गर्नु;दुरूपयोग;अपशब्द;कुप्रयोग;अधिक दुरूपयोग;थिचोमिचो;कुरीति;गाली;दुर्वचन;दुर्व्यवहार;निन्दा;अनुचित व्यवहार;गाली गर्नु;दुरूपयोग गर्नु;दुर्व्यवहार गर्नु;निन्दा गर्नु;झपार्नु;हानि पुर्‍याउनु;बरबाद गर्नु;कुप्रयोग गर्नु;हप्काउनु;दुर्वचन भन्नु;छारस्ट गर्नु	-1
abysmally	निकृष्ट तरिकाले;खराब ढंगले;अगाध रूपले;घोर रूपमा;एकदमै भद्दा	-1
accident	आकस्मिक घटना;दुर्घटना;आपत;घटना;दुर्घटना;दैवयोग;विपद;संयोग;घटना;अप्रत्याशित घटना;आकस्मिक घटना	-1
acclaim	जयध्वनि;जयजयकार;प्रशंसा;समभिनन्दन;सम्मान;साधुवाद;वाहवाही;अनुमोदन;स्तुति गर्नु;प्रशंसा गर्नु;तालि बजाएर अभिनंदन गर्नु;वाह-वाह गर्नु;जयजयकार गर्नु;स्वागत गर्नु;अभिनन्दन गर्नु;समभिनन्दन गर्नु;जय जयकार गर्नु;जयध्वनि गर्नु	1
acclamation	अभिनंदन (m);जयघोष (m);जयजयकार (m);प्रशंसा (f);समर्थन;साधुवाद (m);स्तुति;वाहवाही (f);मौखिक मतदान (m)	1
ace	ताशको एक्का;एक अङ्क;अतिसामान्य परिणाम;अलाइड कमांड यूरोप;अणु;इकाई;एक्का;एक;एस;प्रवीण;लव;को विरुद्ध एस सेवा गर्नु;सजिलै सफलता पाउनु;को विरुद्ध एस बनाउनु;एकै पटकमा प्वालमा हाल्नु;शानदार;सर्वश्रेष्ठ;धेरै राम्रो	1
achlorhydria	आमाशयमा 'हाइड्रोक्लोरिक अम्ल' नहुनु	-1
achromasia	रङहिनता	-1
achromia	छालामा आवश्यक रङको अभाव	-1
acidemia	रगतमा अम्लको मात्रा बढी हुनु;अम्लरक्तता (f)	-1
acne	खटिरा;डन्डीफोर;डण्डीफोर;ब्रण	-1
acquainted	अभिज्ञ;अभ्यस्त;परिचित	1
acquittal	छुटकारा;दोषमोचन;मुक्ति;रिहाई;विमुक्ति;विमोचन;दोषमुक्ति	1
addressable	ठेगानायोग्य	1
adept	प्रवीण;कुशल;सिपालु;विशेषज्ञ;दक्ष पुरुष;प्रवीण व्यक्ति;गुरू;कारीगर;पण्डित;प्रवीण;अभिज्ञ;कुशल;गुणी;दक्ष;निपुण;पक्का	1
admirable	मन पर्ने;सम्मान गर्न मन लाग्ने	1
admiration	प्रेम वा आदरयुक्त आश्चर्य;अचम्म;आदर;आभार (m);प्रशंसा (f);विस्मय (m);श्रद्धा (f);स्नेह (m)	1
admire	प्रशम्शा गर्नु;प्रशंसा गर्नु;को समादर गर्नु;मा श्रद्धा राख्नु;गुण गाउनु;समादर गर्नु	1
admiringly	प्रशंसा गर्ने ढंगले	1
admonishing	हप्काउँदै;आलोचनात्मक	-1
adroitly	दक्षतापूर्वक;कुशलताले	1
adulate	अत्यधिक चिल्लो घस्नु;चापलुसी	1
advantageous	फाइदाजनक;लाभदायक;लाभप्रद;लाभकारी;लाभदायक;लाभप्रद;हितकारी;उपकारी;उपयोगी	1
advantageously	उपयुक्तताले;लाभप्रद तरिकाले;उपयुक्तताले;लाभप्रद तरिकाले	1
advisable	अरुलाई सिफारिश गर्न लायक;उचित;उपयुक्त;ठीक;योग्य;सहि परामर्श दिने योग्य	1
aesthetical	सौन्दर्यबोध विषयक	1
affable	शिष्ट;मिजासी;भद्र;मिलनसार;सुशील;मधुर भाषी	1
affirmative	स्वीकारोक्ति (f);हो (f);स्वीकार सूचक शब्द जस्तै हो;सकारात्मक;स्वीकारात्मक;स्वीकार सूचक;हो प्रकट गर्ने व्यक्ति	1
afflict	सताउनु;कष्ट दिनु;पीडित गर्नु;कष्ट दिनु;विपदामा हाल्नु;दुःखी;पीडित हुनु;पीडा दिनु;सताउनु;आक्रान्त गर्नु;कष्ट पुर्‍याउनु;दुःख दिनु	-1
agog	उत्सुकताले;आतुरताले;उत्सुक;विकल	1
agonize	धेरै चिन्तित हुनु;तड्पनु;कष्ट दिनु;अत्यन्त पीडित हुनु;व्यथित हुनु;दु:ख वा क्लेश दिनु;धेरै चिन्तित हुनु	-1
agony	तिब्र बेदना;कष्ट;यातना (f);वेदना (f);व्यथा (f);पीडा;सङ्कष्ट;यन्त्रण;धेरै पीडा;मृत्यु यन्त्रणा;कष्ट (m)	-1
ail	बेदना हुनु;रोग (m);पीडा दिनु;खिन्न गर्नु;बीरामी गर्नु;सताउनु;दु:ख दिनु;बीरामी हुनु;दु:ख वा पीडामा हुनु;व्याधिमा हुनु	-1
ailing	अस्व्स्थ;बिरामी;अस्वस्थ;बीरामी;रोगी	-1
alalia	वाक असक्षमता;बोल्ने शक्तिको हास	-1
alarmed	आश्चर्यचकित;सतर्क;डराएको;शंकित	-1
albinism	रङहिनता;वर्णहिनता;अवर्णता	-1
alienating	छुट्ट्याउने;भेदभाव गर्ने	-1
alleviator	दु:खाइ कम गराउने चिकित्सक	-1
altruism	परसेवा;परोपकारवादी;परोपकार;परार्थवाद;बिना स्वार्थको;अर्काको हित	1
altruistic	परार्थवादी;परोपकारी;लोकोपकारवादी	1
amative	कामुक;प्रेमसम्बन्धी	1
amebiasis	'इन्टामोबिया हिस्टोलाइटिका नामक अमीबाको कारण ठुलो आन्द्राको शलेष्मिक भिल्लिमा हुने शोथ जसबाट आउँमासी देखा पर्दछ	-1
amenity	मनोहरता;रमाइलोपन;सुहाउँदोपन;सज्जनता (f);रमणीयता (f);लालित्य;नम्रता (f);सौन्दर्य  (f)	1
amenorrhoea	ॠतुस्रावहिनता	-1
amiability	मिलनसार (f);सुशीलता;सौजन्य;सौम्यता (f);मैत्रीभाव;रमणीयता;स्नेहशीलता	1
amiable	सुन्दर;प्रिय;सुशील;सौम्य;स्नेही;सबको प्याराे;प्रिय;प्रेमपात्र;मधुरस्वभाव;सुजन;मिलनसार;सर्वप्रिय	1
amicable	सौहार्दपूर्ण;मिल्ने;उपकारी;दयालु;मित्रवत;सौहार्दपूर्ण;स्नेहशील;मिलनसार	1
amiss	सदोष;गलत;बिभ्रमपूर्ण;दोषी;नराम्रो;बिगार;अनुचित;गलत;गल्ती गरेर;भ्रम भएर;गडबड	-1
ammoniuria	पिसाबमा एमोनिया देखा पर्नु	-1
amorous	विलासप्रिय;कामुक;कामुक;प्रणयशील;प्रेमशील;प्रेमी;रसिक;प्रेमातुर;प्रेम सम्बन्ध	1
amorousness	विलासप्रियाता;कामुकता;कामोद्दीपन (f);कामुकता;प्रेम	1
amuse	रिझाउनु;दिल बहलाउनु;मन फेर्नु;मनोरञ्जन गर्नु;अभिनन्दित गर्नु;आनन्द दिनु;दिल लगाउनु;मन बहलाउनु;शान्ति दिनु	1
amusingly	मनोरञ्जनात्मक तरिका;सुखदायक;मनोरञ्जनमा;मनोरञ्जनात्मक तरिका	1
amyloidosis	स्टार्च को जम्मा हुने सँग सम्बन्धीत कुनै रोग	-1
aneroid	झोल नभएको;अनीर;निर्द्रव	-1
anguished	जोडदार मानसिक या शारीरिक पिडा हुनु या देखाउनु;दुःखमय	-1
anisotropic	असमान आवर्तन;असमदिग्वर्ती	-1
annoyed	रिसाउनु	-1
anosmia	सुंघने शक्तीको अभाव;गन्ध अग्राह्य;सुँघ्ने शक्तिको नाश	-1
answerable	उतारदायी;जवाफदेयी;उत्तर दिन योग्य;उत्तरदायी;जवाफदेही;ठीक;उत्तरको योग्य;अनुकूल	1
antibacterial	जीवाणुलाई नस्ट गर्ने;प्रतीजीवाणु;जीवाणु विरोधी;प्रतिजीवाणु	1
antifungal	दुसिजन्य जिव को सङ्क्रमण विरुध्द प्रयोग गरिने पदार्थ/ औषधी	1
antimicrobial	सुक्ष्म जीवाणु विरुध्द काम गर्ने पदार्थ;सूक्ष्मजीवीरोधी;सूक्ष्मजीवीरोधी	1
antipode	कुनै अरु कुरा को ठ्याक्क बिपरित;उल्टो;उल्टा;कुनै अरु कुराको ठ्याक्क बिपरित	1
aortitis	महाधमनिको शोथ हुनु/ सुन्निनु	-1
aphrodisia	कामवासना;यौन चाहना	1
aphrodisiac	कामोत्तेजना बढाउने औषधी	1
appendicitis	आन्द्रामा भएको एक किसिमको बिमार;आन्त्रपुच्छ-कोप;उण्डुक-शोथ	-1
appetent	अती उत्सुक	1
arable	कृषियोग्य;कृषि-योग्य;कृषित;कृष्ट;कृष्य;कृषि योग्य;जोत्ने योग्य	1
archetype	मुल रुप;आदर्श (m);आदिरूप;आद्यरूप;मुल रुप	1
arrant	दुष्ट;अतीनिच;अत्यन्त;कुख्यात;निरा;पक्का;परले दर्जेकाे	1
arrhythmic	मुटुको अनियमित धड्कनसम्बन्धी;मुटुको अनियमित धड्कनसम्बन्धी	-1
arteritis	कुनै धमनिको शोथ हुनु	-1
artfulness	चतुराई	1
aseptic	किटाणु रहित;अपूतित;कीटाणुहीन;पूतिहीन	1
ashamed	सरम;लाज;लज्जित;लाज;शर्मिन्दा;सरम	-1
assailable	रक्षा नगरिएको या रक्षा गर्न नसकिने;अरक्षणीय;आक्रमणीय	-1
asset	पुजी;गुण (m);परिसम्पत्ति;सम्पत्ति (m);पुजी	1
associative	सम्बन्ध;सहचारी;साहचर्य;जोड्ने वस्तु	-1
assuage	शान्त गराउनु;कम गर्नु;सन्तोष दिनु;बुझ्नु;काम गर्नु;शान्त गर्नु;धीमा गर्नु;हल्का गर्नु;चिसो गर्दिनु	1
asthmatic	दमको रोगी;श्वास रोग सम्बन्धी	-1
ataxia	मांसपेशिको अनियमित कार्य;पेशिय क्रीयाको अनियमितता;गतिविभ्रम	-1
atrocious	अतिदुष्ट;निर्दय;क्रुर;दुष्ट	-1
atrocity	अत्याचार;नृशन्सता (f);महापाप (m);घोरकर्म;भारी दुष्टता;अत्याचार (m);क्रूरता	-1
attractive	आकर्षक;प्रलोभक;मनभावना;मनमोहक;मनोहर;रोचक;सुन्दर;सोहनी;मनमोहन	1
attributable	आरोप्य;रोप्य;जसको कारण निश्चित गर्न सकिन्छ;जसको सम्बन्ध लगाउन सकिन्छ	1
atypical	सामान्य अवस्थाबाट विचलित हुने चिज;असामान्य;अप्ररूपी	-1
auspice	शकुन;लक्षण;रक्षा;शकुन (m);शकुन-विचार	1
auspicious	शुभ;माङ्गलिक;शुभ;सम्पन्न;मङ्गलसूचक;राम्रो;अनुकूल;धन्य;मङ्गल	1
autistic	स्वध्यान केन्द्रित व्यक्ती;दिवा सपना देख्ने;बाह्य जगतसँग कुनै मतलब नराख्ने;स्वलीन	-1
avirulent	विषाणुहिन;विषाणुरहित	-1
avoidable	छोड्न वा त्याग्न मिल्ने;परिहार्य;टार्ने योग्य;निषेध गरिएको	1
aware	सतर्क;अभिज्ञ;अवगत;जानकार;परिचित;सचेत;सावधान;जागरूक	1
awesome	उत्तम;एकदम राम्रो;कमालको;अद्भुत;भयानक;विस्मयकारी;विस्मयाकुल;महिमामय;अत्यन्त प्रभावशाली	1
bad	खराब;नराम्रो;नाश;सडेको;खराब;बिरामी;सडेको;नराम्रो;वसुल गर्न नसकिने वस्तु;खोट भएको;अकुशल;गम्भीर;अनर्थकारी;गलत;अनुपयुक्त;अमान्य	-1
bad-mannered	अशिष्ट	-1
bad-tempered	असहिष्णु;उतावलोपन	-1
badness	दुष्टता (f);दुष्ट (f);खराबी (f)	-1
bane	नाश;विनाश;क्षयकरण;मृत्यु (f);विनाश (m);विपत्ति (f);विष (m);व्यथा (f);शाप (m);लानत;विनाशको कारण (m);चिन्तित अथवा रीस उठाउने व्यक्ति;बिगार(m);नाश (m)	-1
bang-up	शानदार	1
bankrupt	ॠण तिर्न नसक्ने मानिस;ऋणशोधनाक्षम;दिवालिया गर्नु;दिवालिया	-1
banner	झण्डा;ध्वजा;झन्डा;झन्डी;ध्वजा;सौभाग्य (m);ब्यानर	1
bantering	मजाक अथवा परिहासले सम्बन्ध राख्ने  व्यक्ति;हसी मजाक	1
bastard	नाजायज सन्तान;नकली;वर्णसंकर;हरामी;घटिया मान्छे;नाजायज सन्तान;हराम;अवैध;खोटो;फोहरी;घटिया	-1
bearable	स्विकारयोग्य;सहनीय;स्विकारयोग्य;सहने योग्य	-1
beautiful	सुन्दर;राम्रो;अकर्षक;सौन्दर्ययुक्त;स्वादिष्ट;आकर्षक;सुन्दर;उत्कृष्ट;प्यारो	1
becoming	हो जानु;हुँदै गइरहेको;यथोचित;योग्य;शोभाजनक;स्टाइलिश;असल;राम्रो;उचित;उपयुक्त;उपयोगी	1
begrime	मैला गर्नु	-1
beholden	अनुग्रहीत;आभारी;कृतज्ञ;उपकृत	1
believable	पत्याउन सकिने;विश्वास गर्न योग्य;सम्भावित;विश्वसनीय;विश्वास-योग्य;सम्भावित;सम्भाव्य;विश्वास गर्न योग्य	1
bemire	फोहोर गर्नु;मलिन हुनु;हिलो छेप्नु	-1
bemoan	शोक गर्नु;रुनु;पश्चाताप गर्नु;दु:ख ब्यक्त गर्नु;पश्चात्ताप;रूनु;रूनु-पीट्नु;विलाप गर्नु;दुख प्रकट गर्नु	-1
beneficence	उपकार;उपकारिता;कृतज्ञता	1
beneficent	उपकारी;परोपकारी	1
beneficial	लाभजनक;उपयोगी;गुणकारक;लाभकारी;लाभदायक;लाभप्रद;हितकर;हितकारी;लाभकारक;लाभदायी	1
benefit	फाईदा;लाभ;अनुग्रह (m);कृपा;गुण (m);लाभार्थ नाटक (m);प्रसुविधा;फायदा (m);भत्ता (m);भलो (m);लाभ (m);सुविधा (f);हित (m);हितलाभ;फाइदा;लाभ पहुँचाउनु;लाभ उठाउनु;भलो गर्नु;हितकारी हुनु;फाइदा हुनु;उपकार गर्नु	1
benevolence	कृपा (m);दया (f);द्रव्यदान;परोपकारिता;भलाई (f);शुभचिन्ता;हित (m);उदारता;उपकार	1
benevolent	दयालु;हितैषी;शुभचिन्तक;सद्भावपूर्ण;दयालू;भला चाहाने व्यक्ति;उदार;कृपालु;दयालु;परोपकारी;भद्र;शीलवन्त	1
benignant	दयालु;कृपालु	1
bereaved	वन्चित;शोकसन्तप्त;शोकार्त्त	-1
best	असल;उत्तम;शुभकामना (f);सर्वर्श्रेष्ठ प्रयास;श्रेष्ठता (f);सर्वश्रेष्ठ व्यक्ति;योग्य मूल्य;यथासाध्य चेष्टा;श्रेष्ठ अवस्था;सर्वर्श्रेष्ठ;धेरै राम्रो तरिकाले;उत्कृष्ट;सर्वोत्तम रीतिले;उत्तम;सर्वश्रेष्ठ;सबै भन्दा राम्रो;श्रेय;श्रेष्ठ;सर्वोत्कृष्ट;सर्वोत्तम;अत्यधिक प्रभावशाली;प्रशस्त;सर्वोतम;उच्च	1
better	ठीक;असल;सुधार;उन्नति (f);श्रेष्ठता (f);शर्त लगाउने व्यक्ति (m);योग्य व्यक्ति (m);सुधार (m);उत्तम बनाउनु;अधिक शिक्षा प्राप्त गर्नु;राम्रो आय प्राप्त गर्नु;सम्हाल्नु;सुधार्नु;अझ राम्रो बनाउनु;सुधार्नु;अगाडि बढाउनु;उँचो;ठीक;ठुलो;राम्रो;श्रेष्ठतर;धेरै राम्रो;अधिकांश;अझ राम्रो तरिकाले;उत्तम तरिकाले	1
better-looking	सुन्दर	1
bias	पक्षघात;झुकाव (m);ढलान;ढाल;तरफदार (f);पक्षपात (m);भाव (m);पूर्वाग्रह (m);कुनै गोलो वस्तुको एउटा पक्षको एक भाग;दबाव हाल्नु;झुकाउनु;तरफदारी गर्नु;तेर्छो	-1
biodegradable	जीवाणुले नष्ट गर्न सक्ने;स्वाभाविक तरीकाले सहनशील;जैवनिम्नीकरण (m);प्राकृतिक तरीकाले सहनशील;स्वाभाविक तरीकाले सहनशील;जैव निम्नीकरणीय	1
blackguard	अनादारपूर्ण काम गर्ने ब्यक्ती;दुर्जन;बदमाश (m);गाली दिनु	-1
blain	खटिरा	-1
blepharitis	परेलिहरु मध्ये शरीरमा सुनिएको भाग	-1
bliss	परमानन्द;मोक्ष;आनन्द (m);कल्याण (m);परमानन्द (m);मंगल;विलास;स्वर्गसुख;हर्ष;परम सुख	1
blithesome	डोरी;प्रफुल्ल;हर्षपूर्ण	1
bloodthirsty	रगतको प्यासी;पिशाच;निर्दयी;रक्तपिपासु;रगतको प्यासी	-1
bobble	बललाई पक्रिन वा रोक्नमा  असफल रह्नु	-1
bogus	नक्कली;बनावटी;जाली;झूटो;नक्कली;निकम्मा;बोगस;कल्पित	-1
boneless	कमजोर	-1
bonnie	आकर्शक;धेरै मन पर्ने;सुन्दर;सुदर्शन	1
bonny	आकर्शक;सुन्दर;राम्रो;आकर्शक;खेलाडी;चन्चल;चपल;मग्न;रूपवान;सुन्दर;हर्षित;स्वास्थ	1
boon	कृपा;प्रसाद;अनुग्रह (m);उदार;कृपालु;दाता (m);प्रसाद;प्रार्थना (m);मृदुस्वभाव;लाभ;वर (m);वरदान (m)	1
boss	नेता;प्रमुख;अधिनमा राख्नु;बस;बूटा (m);मालिक (m);मौलिक;शासक;साहेब;स्वामी (m);अगुवा (m);अधिपुरुष;नेता (m);प्रबन्धकर्ता (m);फूली;प्रबन्ध गर्नु;आदेश दिनु;राज्य गर्नु;प्रबन्ध गर्नु;सन्चालन गर्नु;शासन गर्नु;नियन्त्रण गर्नु;मालिक हुनु;धाक देखाउनु	1
botch	खटिरा;कलंक	-1
bounden	नैतीकताको लागि गर्नुपर्ने काम	1
bounder	अपमानजनक व्यवहार गर्ने;बेइमान	-1
boundlessness	अनन्त;कुनै सिमा नभएको	-1
brag	फुर्ती लगाउनु;घमण्ड गर्नु	1
brilliant	प्रतिभाशाली;अती चतुर;रत्न (m);हीरा (m);धेरै राम्रो;बुद्धिमान;भडकीलो;वैभवशाली;शिक्षित;उत्कृष्ट;गुणयुक्त;मेधावी;चम्किलो;धेरै राम्रो;चम्कीलो;तेजोमय	1
brio	खुसी;उत्साह	1
bulimic	क्षुधा पीडित;क्षुधाग्रस्त;क्षुधाग्रस्त	-1
bully	हेप्नु;डर देखाउनु;झगडालू मान्छे;हेप्नु;डर देखाउनु;धम्की देखाउने मान्छे;गुण्डा (m);दादा (m);धम्की (m);दबङ्;सताउनु;भयभीत गर्नु;तङ् गर्नु;दुख दिनु;धम्की दिनु;धम्काउनु;धम्की देखाउने मान्छे;शानदार	1
bumbling	झुक्किएको जस्तो काम गर्ने;काम नलाग्ने;बेकार को काम गर्ने;अनाडी;मुर्ख	-1
bumpkin	ग्रामीण;गाउले;असभ्य;गँवार (m);देहाती (m);ग्रामीण;गाउले;असभ्य	-1
bungling	गोलमाल;विफल;जथाभावी	-1
bush	झाडी;पातलो जङ्गल;जङ्गली प्रदेश;मोटो घुम्रेको कपाल;जङ्गल;झाडी;छल्ला लगाउनु;अस्तर;बाक्लो कपाल;बाक्लो जङ्गल;छल्ला लगाउनु;झाडि लगाउनु	-1
cacophonous	कर्कश;कर्णकटु;श्रुतिकटु	-1
calamitous	दुखद;प्रलयंकर;अनर्थकर;अनर्थकारी;आपत्तिजनक;आपद्ग्रस्त;दुःखद;दुःखपूर्ण	-1
calligraphy	अक्षरबिज्ञान;लेख्ने कला;चिठी;सुलेख;हस्तलिपि;लेखावट	1
cankerous	विनाशकारी	-1
cantankerous	झगडालु;कचकचे;कलहप्रिय;चिडचिडा;झगडालू;झगडालू	-1
casteless	अवर्ण	-1
castigate	सास्ती दिनु;निन्दा गर्नु	-1
catastrophic	विनाशकारी;अनर्थकारी;विनाशकारी;प्रलयकर	-1
catching	मनोहर;आकर्षक;पक्रिनु;सुन्नु;ग्रहण गर्नु;बन्दी गर्नु;संक्रामक;लगाउने व्यक्ति	1
cattiness	ईर्ष्या (f)	-1
cautious	बुद्धिमान;सतर्क;सावधान;होशियार;खबरदार;सजग;सावधानपूर्वक	1
centenarian	एक सय बर्ष पुगेको मान्छे;शतवर्षीय;शतायु;सय वर्षको अवस्थाको मनुष्य	1
chagrin	निराशता;निराशा (f);शरम (f);क्लेश (f);लज्जितता (f);लाज (f);संकट (m);संकोच (m);सन्ताप (m);हैरानी (f);जिस्काउनु;परेशान गर्नु;कष्ट दिनु	-1
chastity	सतीत्व;पवित्रता;कसै सँग पनि शारिरिक सम्बन्ध नराख्ने परम्परा	1
cheating	धोकेबाज;विश्वासघात	1
cheerful	आनन्दित;सन्तुष्ट;आनन्दित;सन्तुष्ट;सुखद;हँसमुख;हर्ष;आनन्ददायक;आनन्दित;आरामदायक;उल्लासित;चम्किलो;प्रफुल्ल;प्रसन्न;मग्न;सहर्ष;सुन्दर	1
cherubic	देवदूतको सामान;सुन्दर र मनमोहक;देवदूतको सामान;दिव्य;देवदूतको जस्तै;परीको जस्तै	1
chic	सुन्दर;शैलीयुक्त;टीप-टप;फेशनेबल;सजीलो	1
chichi	अतिसज्जित;बनावटी	1
chide	गाली गर्नु;हप्काउनु;भर्त्सना गर्नु;तिरस्कार गर्नु;निन्दा गर्नु;नराम्रो भन्नु;धम्की दिनु;झिड्क्नु;गाली दिनु;धम्काउनु;सुनाउनु;गाली दिनु	-1
chirography	हस्तलिपी कला या सिप;सुलेख	1
choice	रोजाइ;छान्ने काम;चुन्नेअधिकार (m);चुन्नु;चुनाव (m);सावधानीपूर्वक चुनिएको;निर्वाचन;प्रकार (m);ठूलो;वरण;उत्तम;विकल्प (m);चयन (m);श्रेष्ठ;चारा (m);चुनिएको;सावधानीपूर्वक चुनिएको;ठूलो;राम्रो	1
churlish	कञ्जुस;अशिष्ट;अभद्र;अशिष्ट;कन्जूस	-1
clean-cut	सुसंस्कृत;स्पष्ट	1
cleanable	सफा गर्न सकिने	1
cleanness	संशुद्धि;सफाई (f);पवित्रता;शुद्धता	-1
clever	चतुर;चनाखो;चलाख;समझदार;ज्ञानपूर्ण;गुणी;चतुर;दक्ष;निपुण;प्रवीण;बुद्ध;बुद्धिमान;योग्य	1
cockiness	जिद्दी;धृष्टता;साहस;साहसिकता	-1
cognizable	ज्ञेय;संज्ञेय	1
colic	वायुको गोला;अन्त्रशूल;पेट दुखाई (m);पेटको दुखाई	-1
colicky	पेट र आन्द्रामा अत्याधिक ग्यास भरिएको अवस्था;पेटको दुखाइ सम्बन्धी	-1
collapsible	दबाउने व्यक्ति;समट्ने व्यक्ति	1
color	रङ;रङ (m);जीवन्तता (f);राग;वर्ण;रोग;रङ्गाउनु	1
colour	रङ;वर्ण;रङ (m);देखावा (m);वर्ण;लाली (f);वर्ण (m);वास्तविकता (f);जीवन्तता (f);झण्डा (m);ढोग (m);बाहाना (m);रङ्गाउनु;अनुहारमा रङ आउनु;रङ चढाउनु;रङ दिनु;भडक्नु;अपराध लुकाउनु;लजाउनु;विश्वास योग्य कुरा बनाउनु;लज्जित हुनु;बद्ला दिनु;रङ्गीन	1
comeliness	चारुता;सुहावनापन;मनोरमता	1
comely	राम्रो;लोभलाग्दो;उपयुक्त;प्रिय;मनोरम;समुचित;सुहावना;सुदर्शन	1
comeuppance	सजाय या भाग्य को खेल;गाली गर्नु;डाँट्नु;हप्काउनु	1
comfortless	असुविधाजनक;बेआराम	-1
comically	हसाउँरो पाराले	1
commendable	तारिफ गर्न योग्य;प्रशंसनीय;सराहनीय	1
commonsense	समझ;सहज बुद्धि (f);सामान्य बुद्धि वा बोध;व्यावहारिक ज्ञान	1
compassion	सहानुभुती;दया;सहानुभूति;अनुकम्पा;करुणा (f);कृपा;क्षमा;दया (f);संवेदना (f)	-1
compassionate	दयालु;उदार;दया वा सहानुभूति देखाउनु;सहानुभूतिशील;दयापूर्ण;करुणामय;कृपालु;दयालु;दयावान;सदय	1
competent	योग्य;लायक;दक्षता;समर्थ;सुयोग्य;अधिकारी;उचित;कार्यक्षम;निपुण;पर्याप्त;योग्य;सक्षम;काबिल;दक्ष	1
complaisant	नम्र;भद्र;विनयपूर्ण;दया;विन्ती	1
comprehensible	विचारणिय;बोध गर्न योग्य;ग्राह्य;बोधगम्य;बोधनीय;सुबोध;सम्झन योग्य	1
compressible	खाद्न मिल्ने;थिच्न मिल्ने	1
concupiscence	यौनप्रेमी;काम;कामुकता (f);विषयसक्ति	1
confiding	विश्वस्त;ढुक्क;सहज रूपले विश्वास;सहज रूपले विश्वास	1
confuter	विपरित तर्क वा प्रमाण प्रस्तुत गरेर कसैको तर्कको खण्डन गर्ने ब्यक्ती	-1
congenial	अनुकुल;उपयुक्त;अनुकूल;अनुरूप;सुखद;स्वजातीय;एक जातिको;एक मेलको	1
congratulations	बधाई (f)	1
congruence	अनुरूपता;मेल;समनुरूपता;समशेषता (f);सर्वांगसमता;सामन्जस्य (m)	1
congruity	संगति (f);सामन्जस्य (m);उपयुक्तता (f);औचित्य (m)	1
conscientiousness	अन्तर्विवेकशीलता;कर्तव्यनिष्ठा (f)	1
conserved	संरक्षित	-1
conspicuous	प्रत्यक्ष;खुल्ला;विशिष्ट (m);सुस्पष्ट;यस्तो स्थान वा व्यक्ति जसमा सबैको दृष्टि जान्छ;प्रत्यक्ष;प्रमुख;प्रसिद्ध;विख्यात;सुप्रकट;सुप्रकाश	1
constructive	रचनात्मक	1
consummate	निपुण;बिवाहलाई पुर्णता प्रदान गर्नु (बिहे पछी संभोग गरेर)	1
contemptuous	तिरस्कार वा अपमानयुक्त;घृणायुक्त;घृणित;घृषृ;तिरस्कारक;तिरस्कारपूर्ण;अपमान सूचक	-1
controllable	नियन्त्रण गर्न सक्षम;नियन्त्रणीय	1
controvert	वाद विवाद गर्नु;खण्डन गर्नु;अस्वीकार गर्नु;विवाद गर्नु;खण्डन गर्नु	-1
convivial	रमाइलो माहोल;बातावरण वा उत्सव;उत्सव-सम्बन्धी;खुशीको;उत्सव-सम्बन्धी	1
coolie	कुल्ली;भरिया;कुली (m);मजदूर	-1
cooly	कुली	-1
coquetry	नखरेबाजी (f);सौकीन	1
cordless	तार रहित;बेतार	-1
corking	धेरै राम्रो	1
correct	सहि;ठिक;सुधार्नु;ठीक गर्नु;शिक्षा दिनु;संशोधन गर्नु;सही गर्नु;दण्ड दिनु;दुरुस्त गर्नु;संशोधित गर्नु;सुधारको लागि गाली गर्नु;सही;उचित;ठीक;यथातथ्य;विशुद्ध;शुद्ध;संशोधित	1
corrected	संशोधित	-1
correctness	शुद्धता;विशुद्धता;औचित्य (m);परिशुद्धता (f);यथातथ्यता;यथार्थता;विशुद्धता;सत्यता (f)	1
corruptible	भ्रष्टाचारी;क्षयशील	1
countermand	आदेशको अवहेलना गर्नु;प्रत्यादेश;प्रत्यादेश;रद्द गर्नु;पूर्व आदेशको फिर्ता लिनु	-1
courteous	विनम्र;दयालु;विनम्र;विनयपूर्ण;नम्र;भद्र;मिलनसार;विन्ती;शालीन;शिष्ट;सानुनय;सुशील;सुसम्य	1
courtesy	शिष्टता;विनम्रता;नम्रता (f);भद्रता (f);विनय;शालीनता (m);शिष्टाचार (m);शील;सुशीलता (f);सौजन्य (m);विनम्रता;नवाजी (f);कृपा (m)	1
coveted	इच्छित;बेहद माँगमा	1
crabby	चिडचिडा	-1
crack	चर्कनु;फुट्नु;धमाका (m);चटक्नेको  आवाज;चटेका (m);करारी चोट;एक प्रकारको नशीलो दवाई;चोर;छिद्र (m);मौका (m);आघात (m);कमी;दरार पड्नु;टुक्रा(m);स्फोटन;कोशिश (f);अकाल (m);कड्क (f);मा घुस जानु;खाँचो (m);क्षिप्र उक्ति;गर्जन (f);दवा (f);चटक;दोष;पता लगाउनु;चट्काउनु;पीट्नु;जोरले  टक्राउनु;फाट्नु;चल्नु;जोरको आवाज गर्नु;फोड्नु;गलाको भर्राहट;मार्नु;समाधान निकाल्नु;सुलझाउनु;दरार पड्नु;टूट्नु;तोड्नु;मा घुस जानु;दर्कनु;कड्कनु;मनोवैज्ञानिक दवाबमा आउनु;प्रवीण;जोरदार;सर्वश्रेष्ठ	1
crackerjack	प्रतिभावान व्यक्ति वा वस्तु	1
cracking	तडक;खुर;चटकाहट (f);दरार (f);शानदार;धेरै नै	1
credible	विश्वासलायक;विश्वास गर्न योग्य;प्रत्ययी;प्रामाणिक;विश्वसनीय;विश्वासयोग्य;विश्वास्य;साच्चो;विश्वास गर्न योग्य	1
creepy	डरलाग्दो;अनौठो;संकास्पद;अनौठो;डरलाग्दो, संकास्पद	-1
criminal	अपराधी;दोषी (m);पापी;अपराधी (m);अपराध सम्बन्धि;दण्ड;अपराधिक;अनुचित	-1
cruelty	कठोरता (f);क्रूर;क्रूरता;निठुराई;निर्दयता (f);निष्ठुरता (f);नृशंसता;बेदर्दी;दयाहीनता	-1
culpable	दोष;अपराध;दोष;अपराध;दन्डयोग्य;आपराधि;गुनहगार;दोषपूर्ण;निंदनीय;सदोष;अपराधपूर्ण;अपराधिक	-1
cultivable	खेतीयोग्य;कृषियोग्य;खेती योग्य;कृष्य	1
cultivatable	कृष्य	1
cultured	सभ्य;सुसंक्रित;कृत्रिम;संवर्धित;संस्कृत;सभ्य;सुसंस्कृत	1
cunning	चतुर;कपटी;धूर्तता (f);कपट (m);होशियार;चंट;चतुराई (f);चलाकी (f);चालू;धूर्त;मक्कार;शठ;राम्रो;आकर्षक;होशियार;कपटी;कुटिल;शातिर;चतुर;चलाक	1
curative	रोग निवारक;औषधी;आरोग्यकर;आरोग्यकारी;उपचारात्मक;नीरोगकारी;आरोग्यकर पदार्थ	1
cursory	छिटो;शिघ्र;अधूरो;अनिपुण;त्वरित;सरसरी;सतही;शीघ्रता वा असावधानीले गरिएको;सरसरीले गरिएको	-1
curtainless	बिना पर्देाको	-1
cute	राम्रो;मन हर्ने;आकर्षक;चतुर;चालाक;अति सुन्दर;चिट्ट परेको;मनोरह।	1
cuteness	कुशलता;मनोहरता (f);रमणीयता (f)	1
cystitis	पिसाबको थैली सुनिने रोग;मूत्राशय शोथ (m)	-1
daintiness	सुथरापन;सभ्यता;सूक्ष्मता	1
damaged	बिग्रिएको;क्षतिग्रस्त;बिग्रेको;टूटेको	-1
danceable	नाच्न मिल्ने	1
dandy	गुण्डा;तडक भडक देखाउने मान्छे;डाण्डी;नाव;कश्ती;राम्रो;अलबेला;उत्कृष्ट;उत्तम;छैला;धेरै राम्रो;बाँका;श्रेष्ठ;सजीलो;वस्त्रको र विशेष ध्यान दिने  मनुष्य;धेरै आकर्षक	1
dastard	कातर;कायर	-1
debauch	कलंकीत गर्नु;दुषित पार्नु	-1
deceit	छल;कपट	-1
deceitful	धोका दिनु;ठगी गर्नु	-1
decency	शिष्टता;सभ्यता (f);सुशीलता (f);विनम्रता;भद्र व्यवहार;उपयुक्तता (f);औचित्य (m);मर्यादा (f);लज्जा (f);विनय;शालीनता (m);शिष्टता;शिष्टाचार (m)	1
decent	सभ्य;भलादमी;सभ्य;समुचित;राम्रो;सलज्ज;आदरणीय;सहनीय;उचित;उदार;उपयुक्त;सम्माननीय;प्रतिष्ठित;काफी राम्रो;भलो;मर्यादित;योग्य;लज्जावान;विनीत;शालीन;शिष्ट;श्लील;सन्तोषजनक	1
deceptive	मायावी;छलकारी;कपटपूर्ण;कपटी;छली;धूर्त;भ्रमकारी;भ्रान्तिकर;भ्रामक;मायावी;मायिक;धोखे में डालनेवाला	-1
deceptively	छल गरेर	-1
decorous	नम्र;भद्र;सभ्य;समुचित;सुरुचिपूर्ण;औचित्यपूर्ण;भद्र;मर्यादित;योग्य;विन्ती;शालीन;शिष्ट	1
decorum	नम्रता;सभ्यता;तमीज;औचित्य (m);युक्तता;शिष्टता (f);शिष्टाचार (m);सदाचार;सभ्यता (f);सुन्दरता;नमस्कार	1
deducible	निगम्य	1
defamatory	निन्दापूर्ण;मान्हानी;अपकीर्तिकर;अपवादक;अपवादात्मक;निन्दात्मक;कलंक लगाउने व्यक्ति;मानहानिकारक;अपमान सूचक	-1
defensible	सजिलै रक्षा गर्न सकिने;उत्तर दिने योग्य;बचाउन योग्य;सहजमा रक्षा हुन योग्य;उचित;रक्षणीय;समर्थनीय;रक्षा योग्य	1
dejected	उदास;खिन्न;अनुहार लट्काएको;उदास;फुङ्ग उडेको;निरुत्साहित;मुर्झाउनु	-1
delectable	प्रसन्नचित्त;ललित;सुखद;सुहाउनु;स्वादिष्ट;धेरै आकर्षक;मनभावना;मनोरम;मनोहर;रमणीय;रुचि	1
delicious	स्वादिष्ट;सुस्वाद;आनन्ददायक;मधुर;मनोहर;मीठो;रुचिकार;सुखद;मधुर;स्वादिष्ट;मनोहर;रमणीय;सुखद;स्वादिष्ट	1
delightful	खुशी पार्ने;आनन्दमय;आनन्दित;आनन्ददायक;आनन्ददायी;आनन्दप्रद;दिलचस्प;मंगलमय;मनोहर;रमणीय;रुचिकार;सुखद;आनन्दपूर्ण;आनन्दप्रद	1
deliverable	प्रदेय वस्तु वा उत्पाद;प्रदेय	1
delouse	जूम्रा आदि निकाल्नु वा छोड्नु	1
delude	मुर्ख बनाउनु;ठग्नु;छल्नु;ठग्नु;बहकाउनु;भुलाउनु;धोका दिनु;मोहित गर्नु;भ्रमित गर्नु;भ्रममा पार्नु	-1
delusive	मायावी;भ्रमकारक;ठग्ने;असत्य;अयथार्थ;मोहक;ख्याली;मायिक	-1
delusory	अयथार्थ;भ्रामक;ख्याली;मायिक	-1
deluxe	विशिष्ट;शानदार;सुखद;सुखावह;आलीशान;मोटो;प्रचुर;भव्य	1
demise	मृत्‍यु;निधन;अन्त (m);देहान्त;निधन;पट्टा (m);प्रदान;मरण;मृत्यु (f);समर्पण (m);समाप्ति (f);हस्तान्तरण;प्रदान गर्नु;हस्तान्तरित गर्नु;भाडा वा वसीयत द्वारा हस्तान्तरितन गर्नु;दिनु	-1
demonic	दानविय;राक्षसी;नारकीय;पैशाचिक;राक्षसी;पिशाचग्रस्त	-1
denuded	निरावृत	-1
dependability	विश्वसनीयता (f)	1
deplorable	दु ख दायी;शोकमय;खेदजनक;खोटो;दुःखद;निन्दनीय;नराम्रो;बेचारा;विफल;विलापनीय;शोकमय;शोचनीय;दर्दनाक	-1
depravation	दुराचारिता;नीचता;भ्रष्टता (f);भ्रष्टीकरण;खराबी;बिगड;बिगार्नु;बिग्रनु	1
deprave	भ्रष्ट पार्नु;बिगार्नु	-1
depraved	दुषीत;भ्रष्ट;धूर्तता;खराब;दुष्ट;पथभ्रष्ट;भ्रष्ट	-1
deprecatory	निन्दात्मक	-1
derisory	उपहासपूर्ण;बेतुका;व्यंग्यात्मक;व्यंगपूर्ण	1
derivable	उत्पादक;उत्पादनिय;ग्राहा;अनुमेय;व्युत्पाद्य;मूल खोज्न योग्य	1
desensitize	असम्वेदी बनाउनु	-1
deserve	योग्य हुनु;उचित हुनु;योग्य हुनु;अधिकार राख्नु;को योग्य हुनु;पात्र हुनु;अधिकारी हुनु;लायक हुनु;को पात्र हुनु	1
desirability	अनुकूलता (f);इच्छा;वांछनीयता;यौनाकर्षण (m);अभिलाषा	1
desired	इष्ट;वांछित	1
destructive	विनाशकारी;हानिकारक;विनाशकारी;हानिकार;हानिकारक;उजाड;घातक;ध्वस्तात्मक;विनाशक	-1
destructiveness	विनाशकता	-1
detestable	घ्रिणा वा तिरस्कार गर्न सकिने;घिनौना;घृणास्पद;घृणित;निन्द्य;घृणाको योग्य	-1
detrimental	नोक्सानयुक्त;अहितकार;तुच्छता;हानिकारक;क्षतिकारक	-1
devilment	बदमासी;सैतानीपन;शैतानी (f);हरकत;शेखी;हथकण्ड;कौतुक;ढिठाई;धूर्तता (f);नटखटी;शरारत (m)	-1
dewy-eyed	सहज नै विश्वास गर्ने व्यक्ति;भावुक;सहज नै विश्वास गर्ने व्यक्ति	1
diabolical	निर्दयी;दुष्ट;पापिष्ठ;पैशाचिक;पीशाच;राक्षसी;शेतानी;द्वेषपूर्ण;शैतानकोको;क्रूर;घोर;दुष्ट;नारकीय	-1
diacritic	चिन्हसम्बन्धी	1
diacritical	विशेषक	1
difficult	मुस्किल;कठिन;कष्टमय;जिद्दी;मुश्किल;कठिन;कष्ठमय;जटिल;दुःसाध्य;दुर्वोध;भारी;संकटमय	-1
diffident	संकोची;शंकायुक्त;लजालु;लज्जाशील;शंकालु;शक्की;संकोची;संशयी;शर्मीलो;संकोचशील	1
dignify	महत्व दिनु;इज्जत दिनु;अग्लो गर्नु;सम्मान गर्नु;प्रतिष्ठा गर्नु;सम्मानित गर्नु;पद बढाउनु;सत्कार गर्नु;प्रतिष्ठित देखाई दिनु;गौरवान्वित गर्नु	1
dignity	मर्यादा;महत्व;मर्यादा (f);महिमा (f);मान-मर्यादा (f);इज्जत (f);गरिमा (f);आत्म-सम्मान (m);उपाधि (f);गौरव (m);पद (m);पदवी (f);प्रताप (m);प्रतिष्ठा (f)	1
dilute	पातलो पार्नु;हलुका हुनु;कमजोर गर्नु;फिक्का गर्नु;विरल गर्नु;पानी मिलाएर हल्का गर्नु;फिक्का गर्नु;कमजोर गर्नु;पानीले पातलो गर्नु;गलाउनु;घटाउनु;घोल्नु;फिक्का	-1
dingy	फोहोर;मैलो;मलिन;मैलो;सम्दिग्ध;कालो र महिलो;कालो;फोहोर;धमिलो;फीका	-1
diphtheria	डिप्थीरिया;रोहिणी;गलाको झिल्ली बन्द हुनाले श्वास बन्द हुने रोग;मासु सन्तानिका	-1
dirigible	चलाऊन मिल्ने;नियन्त्रणीय;चलाउने योग्य;परिचालन शील	1
disability	अपाङ्गता;असमर्थता;अक्षमता (f);अपात्रता;अयोग्यता (f);अशक्तता;असमर्थता;असामर्थ्य;निर्बलता;विकलाङ्गता (f)	-1
disablement	अंगहानि;अयोग्यता (f);अशक्तता;असमर्थता (f);विकलांगता (f);पंगु हुनु	-1
disadvantage	हानी;नोक्सानी;दोष;नोक्सान (m);हानि (f);खराबी;प्रतिकूल परिस्थिति;असुविधा;क्षति;घाटा (m);त्रुटि;क्षति पुर्‍याउनु;हानि पुर्‍याउनु	-1
disagreeable	अप्रिय;नमिल्दो;अनिष्ट;अप्रिय;कुत्सित;कुस्वाद;घिनौना;प्रतिकूल;झगडालू;लडाकु	-1
disappointing	निराशाजनक;आशा नरहेको;निराशाजनक	-1
disapprove	निन्दा गर्नु;असहमत हुनु;नापसन्द गर्नु;नापसन्द गर्नु;निन्दा गर्नु;अनुचित सम्झनु;आक्षेप गर्नु;मलामत गर्नु;नापसन्द गर्नु;अस्वीकार गर्नु	-1
disarming	शान्त गर्ने व्यक्ति;शान्त गर्ने व्यक्ति	1
discernible	भेद छुट्याउन हुने;देखाउ;प्रत्यक्ष;स्पष्ट;बुझ्ने योग्य	1
discerning	चतुर;विवेकी;कुशाग्रबुद्धि;ज्ञानी;भेदक;विचारशील;विवेकी;समझदार;सूक्ष्मदर्शी;छिटो सम्झने व्यक्ति	1
discomfiture	लाजास्पद अवस्था;व्याकुलता (f);हार;डराउनु (f);पराजय;पराभव;बेचेनी	-1
disconcerting	हैरान गर्ने व्यक्ति वा वस्तु;हैरान गर्ने व्यक्ति वा वस्तु	-1
disconsolate	निरास;दुखी;उदास;खिन्न;निराश;हैरान;गमगीन;विष्;शोकाकुल	-1
discourtesy	असभ्यता;अभद्रता (f);अशिष्टता (m);असभ्यता;रूखोपन (m);बेअदबी;बेरूखी;अशिष्ट व्यवहार	-1
discrepant	अमिल्दो;भिन्न;असंगत;प्रतिकूल;भिन्न;विभिन्न	-1
discriminable	भेदभाव गरिने;छुट्ट्याउने	1
discriminate	फरक देखाउनु;भिन्नता छुट्याउनु;चिन्नु;पृथक गर्नु;भेद गर्नु;अन्तर गर्नु वा देख्नु;पक्षपात गर्नु;अन्तर गर्नु	1
discriminating	विभेदकारी;विभेदी;विवेकी;विशेषक;भेदभाव गर्ने व्यक्ति	1
discriminative	भेद वा भिन्नता राम्रो सँग छुट्ट्याउन सक्ने;विवेकी;विशेषक	1
disenchant	जादु टुनाको प्रभाबबाट मुक्त हुनु	1
disenchanted	मोहभंग गरिएको;विरक्त	1
disfigure	कुरुप बनाउनु;बिगार्नु;कुरूप गर्नु;रूप बिगार्नु;विरूपित गर्नु	-1
disheartening	निराशामय;हताश गर्ने व्यक्ति	-1
disheveled	कपाल नकोरिएको;अस्त-व्यस्त;फोहोर;मैलो-कुचैला;बिग्रेको	-1
dishevelled	अस्त-व्यस्त;कपाल बिग्रेको व्यक्ति	-1
disillusion	भ्रमबाट मुक्ती;आशाभंग;निराशा;मोह-भंग (m);मायूसी;भ्रान्ति मुक्त;भ्रम दूर गर्नु;निराश गर्नु;निराश गर्नु;भ्रम निवारण गर्नु;मोह भंग गर्नु;भ्रम दूर गर्नु	1
disinclined	अनिच्छुक;विमुख	-1
disparaging	अपमानजनक	-1
displeased	बेखुस;रूष्ट;असन्तुष्ट;अप्रसन्न	-1
disport	आँफै रमाइलो गर्नु;एक्लै रमाउनु या खुशी हुनु;आमोदप्रमोद गर्नु;क्रीडा गर्नु;खेल्नु;मन बहलाउनु;मस्ती गर्नु	1
disquieted	चिन्तित;परेशान	-1
disruptive	विघटनकारी;अशान्त;अशान्तिकारक;बाधाकारी;हानिकारक	-1
dissenting	असहमति व्यक्त गर्नु;असहमत	-1
distressed	तप्त;परेशान;पुरानो;रोगी;विपदग्रस्त;व्यथित;आकुल;संतप्त;अस्वस्थ;हैरान	-1
distressful	कष्टप्रद;पीडादायी;शोकाकुल	-1
diverticulitis	विपटीशोथ	-1
divination	हुन सक्ने सम्भावित कुरो;जोखाना हेर्ने;भविष्यवाणी (f);शकुन;शकुन-विचार;अटकल;अनुमान	1
dizzy	चक्कर वा रिङ्गटा लाग्नु	-1
dogged	एकोहोरो;घमण्डी;उदास;जिद्दी;कडा;जबरजस्त	-1
doleful	उदास;खिन्नता;शोकाकुल	-1
donate	दान दिनु;चन्दा दिनु;दान दिनु;प्रदान गर्नु;दान दिनु;उपहार दिनु	1
doughy	अस्वस्थ;रोगी;मुर्ख	-1
downhearted	उदास;निराश;हतास	-1
downright	एकदम;सर्वदा;स्पष्टवादी;निष्कपट;पूर्ण रूपले	1
dreaded	खतरनाक;भयानक	-1
dreadful	भयंकर;भयानक;अरुचिकर;खराब;डरावना;बेकार;भद्दा;भयङ्कर;भयानक;भीषण	-1
drifter	उदेश्य नभएको ब्यक्ती;पानीको प्रवाह रोक्ने जाली;पर्यटक;घुमन्ते	-1
drinkable	पेय;पिउने योग्य	1
droll	अनौठो;हासेर;हाँसो गर्नु;मजाक गर्नु;मजाक उडाउनु;हास्यकर	1
ducal	ड्यूकसम्बन्धी	1
dud	फाटेको कपडा;निकम्मा पुरूष;बुद्धू;असफल व्यक्ति (m);व्यर्थ;निकम्मा;बेकार	-1
duly	विधिवत;यथावत्;उचित रीतिले;यथायोग्य;यथासमय;यथोचित	1
duty-bound	कर्तव्यले बाध्य	1
dyslogistic	नरुचाउने;निन्दाजनक	-1
dysmenorrhea	कष्टार्तव	-1
dysphagia	केही कुरा निल्न समस्या हुने एक रोग;निल्नमा कठिनाई	-1
dyspnea	श्वासकष्ट	-1
eclat	सफलता;स्याबासी;ख्याति (f);जय-जयकार;प्रख्याति;प्रशंसा (f);शाबाशी (f);शोभा;अपूर्व सफलता (f)	1
edema	पानी या पीप जमेर सुन्निएको;फुलास;शोफ;स्फाय	-1
egregious	विचित्र;नराम्रो	-1
elaborate	विस्तारित;बयान गर्नु;विस्तारपूर्वक प्रस्तुत गर्नु;विस्तारमा  भन्नु;विस्तारमा भन्नु;विस्तारपूर्वक प्रस्तुत गर्नु;विस्तारले बनाउनु;विस्तृत गर्नु;कठिनाई पूर्वक बनाउनु;परिश्रमले बनाउनु;विस्तार पूर्वक गर्नु;अलंकृत;जटिल;बहुश्रमसिद्ध;विस्तृत;व्यापक;परिश्रमले बनाएको;विस्तारले गरिएको	1
elaborately	खुलस्त पारेर;प्रष्ट सँग	1
elegance	सौंदर्य;कोमलता;स्वच्छता;लालित्य;शिष्टता (f);सुघडपन (m);सुडौलपन (m);सुन्दरता (f);सौष्ठव;रम्यता;सुरुचि (f);औचित्य (m);कोमलता (f);प्रान्जलता	1
eminence	उन्नती;उच्चता	1
emotion	भावना;आवेग;भावना (f);मनोभाव (m);राग;लहर (f);भावावेश;मनोविकार;चित्त वृत्ति;तरंग भाव;आवेग (m);आवेश (m);उमंग (f);जोश;भाव	1
endurable	सहन सकिने	-1
enervate	दुर्बल बनाउनु;कमजोर पार्नु	1
enforceable	कार्यन्वयन गर्ने सकिने	1
enhancer	बढाउने;ब्रिद्धी गराउने	1
enlightened	शिक्षित;ज्ञानी	1
ennoble	सभ्य पार्नु;उच्च बनाउनु	1
enrage	रिस उठाउनु	-1
enthusiastic	उत्साही;जिसिलो;उत्साहपूर्ण;उत्साहयुक्त;उत्साही;उत्सुक;उमंग;सरगर्म	1
erotic	कामुक;उन्मत्त	1
erroneous	त्रुटी;गलत	-1
erudite	ज्ञानी;शिक्षित	1
esteemed	आदर र सम्मान गर्नु	1
estimable	आदरणिय;सुधार	1
estranged	विरक्त;रन्जिशजदा	-1
euphony	स्वरको मिठास	1
evident	स्पष्ट;प्रकट;प्रकट;प्रत्यक्ष;व्यक्त;सुस्पष्ट;स्पष्ट;जहिर (n)	1
evil	दुष्ट;पापी;नराम्रो(f);विपद;हानि (f);खराबी;अमंगल;दुष्टता (f);नुकसान;पापी;नराम्रो;हानिकर;अशुभ;खराब;गन्दा;दुष्ट;निंद्य	-1
exalted	महान;हर्ष	1
excellent	श्रेष्ठ;उत्तम;उत्कृष्टता (f);धेरै राम्रो;बहुमूल्य;श्रेष्ठ;प्रशस्त;राम्रो;अत्युत्तम;अनोखा;उच्च;उत्कृष्ट;उत्तम;गुणवत्त	1
excise	कर तिर्न लगाउनु;प्रतिदान;विदेशी मुद्रा;लेन-देन (m);वस्तु-विनिमय;बदली गर्नु;विनियम (m);बिजुलीको केन्द्र;हुण्डियावन;आदान प्रदान गर्नु;अदला बदली;अदला बदल;आदान-प्रदान (m);आदान प्रदान केन्द्र (जस्तै टेलिफोन, विद्युत आदि) (m);केन्द्र (m);अदला बदला;द्रव्यशेष;निविमय;परिवर्तन (m);चोक जाँहा व्यापारीगण एकत्र होन्छन्;बदल्नु;अदला बदलाी गर्नु;आदान-प्रदान गर्नु;बदली गर्नु;बदल दिनु;विनिमय गर्नु;अदला बदली गर्नु;हाल्नु;लेन देन गर्नु;विनिमय;ट्रान्सफर	-1
excusable	माफ गर्न सकिने	1
execrable	नराम्रो;हेला  गर्न हुने	-1
exhaustible	प्रयोग गरेर सकिने या बिलिने;नाश हुने	1
exhaustive	थकाउने;खाली गर्ने व्यक्ति;थकाउने व्यक्ति;परिपूर्ण;पूरा;पूर्ण;विस्तृत;व्यापक;सम्पूर्ण;सुविस्तृत;सुक्ने वस्तु	1
explainable	बुझ्न वा बुझाउन सकिने	1
explicable	व्याख्या गर्न योग्य;सार्थक;स्पष्ट;स्वाभाविक	1
expressible	ब्यक्त गर्न सकिने	1
extant	जिवित;प्रचलीत	-1
extol	प्रशंसा गर्नु;बढाइ चढाइ गर्नु	1
fab	गतिलो;शानदार	1
fabled	प्रख्यात;झूटो;काल्पनिक;पौराणिक;प्रसिद्ध;मनगढन्त	-1
facetious	हसाउने वा ख्यालठट्टा गर्ने;ठठोल;मजा गरेको;मजाकी;विनोदशील;विनोदी;हँसमुख;हाँसेर;हासोत्पादक;बेमानी;हाँस्ने व्यक्ति	1
faint	मुर्छा पर्नु;बेहोस् हुनु;मूर्छा (f);शिथिल हुनु;बेहोश भएर लड्नु;मुरझाउनु;निर्बल हुनु;मूर्छा पर्नु;बेहोश हुनु;अस्पष्ट;कमजोर;शक्तिहीन;शिथिल;दुर्बल;क्लान्त;म्लान;धमिलो;फीका;मूर्च्छित;निर्बल;निस्तेज;बेहोश;मुरझाएको;मन्द	-1
fallacious	बेठिक;झुठो;मिथ्य;गलत;भ्रमपूर्ण;धोकाको;भ्रममा डाल्ने व्यक्ति;अशुद्ध;झूटो;दोषयुक्त;भ्रमजनक;भ्रान्त;भ्रामक	-1
fantabulous	अनौठो;विलक्षण;अतिउत्‍तम;स्‍वपनिल	1
fatality	दुर्घटना;विपती;अपमृत्यु (f);कष्ट;नाश (m);भवितव्यता (f);मृत्यु (f);विपत्ति;कर्म लेख	-1
fear	डर;भय;त्रास;परिशानी (f);बेचेनी (f);भय (m);भीति;रोब;शंका;आशंका (f);सन्त्रास;खटका;संवेग;चिंता;झिझक;डर (m);भयको वस्तु (f);डराउनु;भयभीत हुनु;बाट डर्नु;शंका हुनु;डर जानु;बाट भयभीत हुनु;आशंका गर्नु;भयभीत गर्नु;सन्देह गर्नु;डर्नु	-1
fearlessness	निर्भीकता;निडरता (f)	-1
fearsome	भयंकर;डरलाग्दो;डरलाग्दो;भयङ्कर;भयानक	-1
fecund	मलिलो;उर्बर;उप्जाऊ;उर्वर;फलप्रद	1
feigned	बनावटी;झुटा	-1
felicitous	आनन्दमय;राम्रो;आनन्दप्रद;परम सुखी	1
felicity	आनन्द;सुख;उत्तम प्रकारले;परम सुख (m);आनन्द (m);आशीर्वाद;कल्याण;सौभाग्य;सुख चैन (m)	1
fertile	उर्बर;मलिलो;जननक्षम;अधिक;उब्जाऊ;उर्वर;प्रचुर;फलदायक	1
fetching	आकर्षक;मन पर्दो;आकर्षक;मनोहर;मोहक	1
fetid	गन्हाउने;दुर्गन्ध;दुर्गन्धयुक्त	-1
fettle	अवस्था;दशा	1
fevered	ज्वरले तप्त;उत्तेजित;जरोले ग्रस्त;अति उत्तेजित हुनु	1
fidgety	चकचके;चन्चले;अधीर;चंचल;बेचैन;व्याकुल	-1
filigree	सुन चादीमा बुट्टा भर्नु;पातलो जालीको काम	1
filthy	फोहोरी;अशुद्ध;धेरै खराब;अपवित्र;अशुद्ध;अश्लील;कुत्सित;फोहोरी;भ्रष्ट;मैलो;घिन लाग्ने सीमासम्म;धेरै खराब;धेरै	-1
fine-looking	सुन्दर	1
fineness	पातलोपन (m);सुंदरता;सुकुमार (f);उत्कृष्टता (f)	1
fireproof	आगो निरोधक;आगोले असार नगर्ने;अग्निजित;अग्निरोधक;अदाह्य;आगोले नबल्ने;अग्नि निरोधक	-1
first-class	उच्च दर्जाको	1
first-rate	राम्रो अवस्थामा;उच्च दर्जाको;सर्वोत्कृष्ट;राम्रो अवस्थामा	1
fit	ठीक हुनु;मिल्नु;समुचित बनाउनु;माड्नु (m);तन्दुरुस्त बनाउनु;स्वस्थ बनाउनु;बिमारीको चढाव;कामको उपयुक्त बनाउनु;को लागि उपयुक्त हुुनु;को लागि ठीक हुनु;नापको;को लागि ठीक हुनु;ठीक गर्नु;सही बसाउनु;ठीक हुनु;शोभा दिनु;बसाउनु;उपयुक्त हुनु;समुचित बनाउनु;योग्य हुनु;योग्य बनाउनु;तन्दुरुस्त बनाउनु;संगत हुनु;स्वस्थ बनाउनु;अनुरूप हुनु;सजाउनु;बस्नु;अनुरूप र्गनु;कामको उपयुक्त बनाउनु;नियोजन गर्नु;लायक हुनु;जाँच्नु;जोड्नु;को लागि उपयुक्त हुनु;अनुकूल हुनु;उपयुक्त बनाउनु;प्रस्तुत गर्नु;तन्दुरुस्त;तैयार;कामको;योग्य;लायक;अनुरूप;उचित;स्वस्थ;उपयुक्त;दुरूस्त;ठीक	1
fitting	उचित;ठिकठाक पर्ने काम;अनुकूलन (m);उपस्कर (m);जमाउनु;नियोज्य;पुर्जा (m);सामान (m);फिटिङ्ग (f);कपडा बनाउनु;उचित;उपयुक्त;योग्य	1
flim-flam	बकबक;बकवास	-1
flirtation	प्रेम अभिनय;प्रेम सम्बन्ध;खेलवाड	1
fogbound	कुहिरोमा फसेको;कुहिरोले रोकिएको;कुहिरो द्वारा परेशानी	-1
foolhardy	मुर्ख्याइ;धेरै खतरा लिने;असावधान;उतावलो;दुःसाहसी;निकै साहसिक	-1
foolishly	मूर्खतापूर्ण तरीकाले;अज्ञानताले;मूर्खताले	-1
foolproof	विश्वसनीय र सजिलो;सजिलो;मामूली;सरल;सीधा;पक्का र सजिलो;विश्वसनीय र सजिलो	-1
footloose	जुन सुकै ठाउँ जानको लागि पनि स्वतन्त्र	1
forged	जाली;नक्कली	-1
formidable	भयङ्कर;डरलाग्दो;भयानक;डराउने;दुर्जेय;भयंकर;विकट;साहस तोड्ने व्यक्ति;दस देने व्यक्ति	1
forswear	अस्विकार गर्नु;त्याग्नु;झुटो कसम खानु;किरिया वा प्रतिज्ञा गर्नु;झुटा शपथ खानु;शपथ खाएर अस्वीकार गर्नु;अस्वीकार गर्नु	-1
fortunate	भाग्यशाली;शुभ;मंगलमय;शुभ;सौभाग्यवान;सौभाग्यशाली;कल्याणमय;नक्षत्री;भाग्यवान्;बधाई;सुकृत;सुलक्षण;सौभाग्यपूर्ण;अनुकूल;दैवशाली;भाग्य;भाग्यवान;भाग्यशाली	1
foxiness	धूर्तता (f)	1
fragrant	सुगन्धित;वासनादार;वास्नादार;सुगन्धित;सुवास	1
fraudulent	छल गर्ने;जाल्झेल गर्ने;अधर्मी;कपटपूर्ण;कपटी;चालबाज;छलपूर्ण	-1
fraught	केही नराम्रो हुन लागेको वा हुने संकेत दिने;भरपूर;भारयुक्त;व्याकुल;भरिएको	-1
frightful	डरलाग्दो;भयङ्कर;धरै खराब;धेरै खराब;डरलाग्दो;भयङ्कर;भयानक	-1
frivolous	असावधानी;खेलाची;चन्चल;तुच्छ;हलुका	-1
frostbite	तुशारोपण;चिसोले शरीरको असार गरेको;धेरै चिसोले सुन्न हुनु	-1
frown	क्रोधले आँखा तर्नु;घुड्की;तेवर (m);त्योरी (f);नाक-भौं चढ्नु;तेवर चढ्नु;भौं चढ्नु;घुड्काउनु;क्रोध गर्नु	-1
fruitfulness	उप्जाऊपन;परिपूर्णता	1
functionality	व्याबहारिकता;काम लाग्ने;कार्यात्मकता;व्यवहारिकता (f)	1
furtive	गोप्य;चोरिको;गुप्त;रहस्यमय;चोरीको;लुकाएको;लुकि छिपी;चोरी छिपे	1
furtively	गुप्त रूपमा	1
gaiety	आनन्द;मोज्मज्जा;उल्लास;खुशी;प्रफुल्लता;प्रसन्न	1
gainfulness	लाभ वा मुनाफा दिने गुण भएको	1
gainly	सुविस्ता सँग	1
gammy	लँगडा	-1
gas-tight	हावा बन्द	-1
gastroenteritis	पेटमा जलन	-1
general-purpose	व्यापक प्रयोजन	-1
genteel	शिस्ट;सभ्य;बनावटी;भद्र;शिष्ट;सज्जन;सभ्य;सुशील	1
genteelness	सज्जनता	1
gentility	खान्दानी;सभ्यता;भद्रता (f);शिष्टाचार;सज्जनता	1
gentlemanly	भलाद्मी;भद्र मनिस	1
gettable	प्राप्य	1
gilt-edged	सुरक्षित;पहिलो दर्जाको	1
gingivitis	गिजाको जलन	-1
gladdened	हर्षित	1
gladsome	खुस;प्रसन्न;आन्नदमय;खुशी;प्रसन्न	1
glamor	चमक;जादु;मोहकता;रङ;जादु गर्नु;मुग्ध गर्नु;प्रभावशाली	1
glamour	मन मुग्ध पार्ने सौन्दर्य;चमक (m);तडक-भडक (f);माया;मोह;मोहकता (f);लावण्य (m)	1
glowing	धेरै तारिफ गर्दै;चम्किदै;उत्साही;जोशीलो;तीव्र;प्रज्वलित	1
godless	नास्तिक;अधर्मी;अनीश्वरवादी;क्रूर;दुष्ट;नास्तिक	-1
gonorrhea	सुजाक;सुजाक;धातुमेह;मधुमेह	-1
gonorrhoea	भिरिङ्गी रोग;यौन सम्बन्ध बाट सर्ने एक रोग	-1
good	राम्रो;असल;कुशल;क्षेमा;भलाई (f);लाभ (m);पुण्यात्मा;प्रफुल्लता (f);सुविधा;हित (m);उपकार;कल्याण;भलो;खरो;खुब;मान्य;ज्यादा;योग्य;ठीक;ठोस;लाभदायक;राम्रो;दयालु;विनोदी;अनुकुल;धार्मिक;शुभ;निपुण;सन्तोषजनक	1
good-hearted	दयालु	1
good-humored	सुशील;राम्रो आचरण	1
good-looking	सुन्दर;दर्शनीय;रमणीय;सुन्दर	1
good-natured	सिशील;राम्रो आचरण	1
goodness	उदारता;सद्गुण;रिस वा आश्चर्य जनाउने शब्द;दया;गुण;श्रेय;भगवान	1
gorgeous	धेरै सुन्दर;चम्किलो;ऊम्दा;भव्य;भडकावदार;भडकीलो;शानदार;शोभायमान;सुन्दर;सुहावना	1
governable	शासन गर्न योग्य;शासनीय;शासनको योग्य	1
gracious	दयालु;कृपालु;दयामय;अनुकूल;आरामदायक;कृपालु;दयालु;दयाशील;धार्मिक;रमणीय;विनीत;सुन्दर	1
grating	जाली;ख्वार ख्वार कोरेको आवाज;जाली;जाल मार्ग;कठोर;कर्कस;कडा	-1
greatest	महान;सबै भन्दा ठुलो;अधिकतम;बृहत्तम;महत्तम;महानतम	1
greathearted	दाँयालु;असल आचरण को	1
grief-stricken	शोकमा डुबेको	-1
grievous	शोककारी;पिडादायी;क्षतिकर;दुःखद;कष्टकर;कष्टदायक	-1
grime	फोहोर पार्नु;कालिख;मैलो (m);मैलो गर्नु;फोहोर गर्नु;अपवित्र गर्नु	-1
groovy	धेरै राम्रो;शानदार;सुखद	1
grotty	फोहोर;घिनलाग्दो;घटिया	-1
groundbreaking	अभूतपूर्व	1
groveller	निच वा अधर्मी मान्छे	1
grubby	फोहोर;मैला;घुन लागेको;घुन सम्बन्धि;अनैतिक;फिहोर;मैलो	-1
gruff	कडा;कठोर;अशिष्ट;कठोर;कर्कश	-1
guarded	होसपुर्वक वा सावधानीपुर्वक गरेको;संरक्षित;सावधान	1
guilt	दोष;अपराध (m);कसूर;जुर्म (m);दुष्टता;दोष (m);पातक;पाप (m);अपराध बोध	-1
guiltiness	दोषी	-1
gusto	जोश;उमङ;आनन्द;खुशी;रूची;हर्ष;आवेश	1
gutsy	बहादुर;लोभि;जोशिलो;साहसी	-1
hadj	हज यात्राा	-1
haematoma	रगत जम्मा भएर सुन्निएको	-1
hairsplitting	छिद्रान्वेषण (m);सानो;तुक्ष्छ	1
hale	खाइलाग्दो;बलियो;तन्दुरुस्त;स्वस्थ;हट्टा कट्टा;स्वस्थ	1
ham-fisted	बेडौल;भद्दा	-1
handsome	भद्र;सुन्दर;उचित;उत्तम;उदार;दयालु;दाता;मनोहर;रमणीय;रूपवान;सुन्दर;सुकुमार;सुरूप	1
hapless	अभागी;भाग्यहिन;दयनिय;दीन;भाग्यहीन	-1
happiness	खुसि;आनन्द;आराम;खुशी (f);भाग्य;मजा (f);रस;लक्ष्मी;शुभ;सिद्धि;सुख (m);सौभाग्य (m)	1
happy	खुशी;हर्ष;मग्न;मदहोश;आनन्दमय;आनन्दित;आनन्दित;शुभ;उल्लासपूर्ण;सन्तुष्ट;खुशी;सानन्द;सुखद;धन्य;सुखी;प्रसन्न;सौभाग्यशाली;सौभाग्यशील;भग्यवान;हर्षित (m);भाग्यवान;आनन्दपूर्ण;गद्गद्;मंगलमय;प्रमुदित;मगन	1
hardhearted	निष्ठुरी	-1
harmonious	सुर र ताल मिलेको;सुडौल;सुरीलो;सुव्यवस्थित;सुसङ्गत;अनुरूप;मैत्रीपूर्ण;लयबद्ध;समस्वर	1
hate	मन नपराउनु;घृणा गर्नु;बैर;कीना;घृणा (f);द्रोह;द्वेष (m);नापसन्द (f);घृणा गर्नु;बैर राख्नु;द्वेष गर्नु;घृणापूर्ण	-1
hayseed	गवाँर	-1
healing	आरोग्यकर;उपचारात्मक	1
healthful	स्वस्थ्य;निरोगी;आरोग्यकर;तन्दुरुस्त;स्वस्थ;स्वास्थ्यप्रद;स्वास्थ्यवर्धक;नीरोग	1
healthy	तन्दुरुस्त;स्वस्थ्य;गुणकारी;तन्दुरुस्त;निरोग;स्वस्थ;आरोग्य कर;स्वास्थ्यको लागि हितकर	1
heartache	मुटुको दु:खाई वा ब्यथा;मनको व्यथा;मनको दुख;मनोव्यथा	-1
heartbroken	अत्यन्त दुःखी;उदास;अत्यन्त दुःखी	-1
heartburn	असन्तोष;नाखुसी;मुटुको व्यथा	-1
heaven-sent	अत्यधिक समयोचित;दैवकृत;अत्यधिक समयोचित	1
henpecked	स्वास्निले हेपिएको लोग्ने;जोइटिङ्ग्रे;स्त्री वस;पत्निद्वारा नियन्त्रित	-1
hick	प्रादेसिय;प्रान्तिय	-1
hideous	भयङ्कर;भयानक;घिनौना;घृणित;डरावना;भयङ्कर;भयानक;घिनावना	-1
high-grade	उत्कृष्ट	1
high-minded	सज्जन;असाधारण;उत्कृष्ट;कुलीन	1
high-ranking	उच्च श्रेणीको	1
high-risk	जोखिम;उच्च जोखिम	-1
highbrow	बुद्धिमान व्यक्ति;घमण्डी;बुद्धिमान;उच्च वर्गीय	1
higher-up	मुखिया	1
highly	अत्यधिक;धेरै;अति;अत्यधिक;निहायत	1
hobbledehoy	बेरुपको;अप्ठ्यारो मान्छे	-1
holier-than-thou	देखावटी रूपमा नैतिक	1
honorable	माननीय;प्रतिष्ठित;माननीय;इज्जतदार	1
honored	आदरणीय;माननीय;श्रद्धेय	1
honourable	सम्माननिय;आदरणिय;पूजनीय;माननीय;सम्मान्य;आदर सत्कारको योग्य;आदरणीय	1
hooligan	गुण्डा;बदमाश;बदमाश;उपद्रबी	-1
horrendous	भयानक;भीषण;भयानक;भिषण;विकट	-1
horribly	भ्यङ्कर रुपले;नराम्रो तरिकाले	-1
horrific	डर जन्माउने;धेरै बेकार;धेरै बेकार;डराउने;भयंकर;भीषण;रोमाञ्चकारी	-1
howling	गर्जनु;अदभुत;भीषण;महान सफलता	1
humdinger	श्रेष्ठ व्यक्ति वा वस्तु	1
humiliate	हेला गर्नु;अपमानित गर्नु;अहङ्कार तोड्नु;दबाउनु;तल देखाउनु;अपमानित गर्नु;तल गर्नु	-1
humiliating	अपमानजनक;अपमानजनक	-1
humor	हासो;ठट्टा;खुशी पार्नु;परिहास;भाव;मनोवृत्ति;हास्य (m);कुरा मनाउनु;कुरा मनाउनु;सन्तुष्ट गर्नु	1
humour	हासो;ठट्टा;खुशी पार्नु;भाव (m);मनोवृत्ति (f);रस (m);रुचि (f);स्वभाव (m);हाँसो (f);आर्द्रता;हास्य (m);चिडचिढाहट;जल (m);उग्र स्वभाव;मनको लहर;झुकाव (m);मान राख्नु;सन्तुष्ट राख्नु	1
hurt	चोट पुर्‍याउनु;कष्ट;दुःख पुर्‍याउनु;घाउ (m);चोट (m);ठेस पुग्नु;नुकसान (m);पीडा;हानि (f);दुःख गर्नु;दुःख दिनु;कष्ट दिनु;चोट पुर्‍याउनु;चोट पहुंचाना;नुकसान पुर्‍याउनु;हानि पुर्‍याउनु;घायल गर्नु;तकलीफ दिनु;ठेस पुग्नु;पीडा दिनु;आहत;खिन्न;जख़्मी	-1
hurting	विश्लेषण	-1
hydrophobic	जल विरोधी	-1
hygiene	शरीरको सरसफाइ;स्वस्थ गर्ने विद्या;स्वास्थ्य विज्ञान (m)	1
hygienic	स्वास्थ्यकर;स्वास्थ्य-	1
identifiable	पहिचान गर्न सकिने;चिन्न सक्ने;अभिज्ञेय;पहिचान योग्य	1
idyllic	रमाइलो;शान्त;काव्यात्मक;ग्रामीण;ग्राम्य;मनोहर;रमणीय	1
ill-mannered	अशिष्ट;असभ्य;नराम्रो स्वभावको	-1
ill-omened	अभागी	-1
ill-starred	अशुभ;असफल;नाकामयब	-1
ill-tempered	दुष्ट;क्रोधी	-1
ill-timed	असामयिक;कुसमय	-1
ill-use	नराम्रो व्यहार;दुर्व्यवहार गर्नु	-1
illegitimate	अवैध;नाजायज सम्बन्धबाट जन्मेको बच्चा;नक्कली;हरामी (n);गैरकानूनी;नाजायज;न्याय विरुद्ध;कम असल;विधि विरुद्ध;अनुचित;अवैध;दोगला	-1
immaturity	अपरिपक्कता;समय नपुगेको;अपरिपक्वता (f)	-1
immoral	अनैतीक;लम्पट;भ्रष्ट;न्याय विरुद्ध;अधर्मी;अनैतिक;चरित्रहीन;दुराचारी;दुश्चरित्र;पथभ्रष्ट;पापी;नराम्रो	-1
immorally	दुराचारसँग	-1
immotile	इस्थीर;एकै ठाउमा रहने;हिंड्न नसक्ने	-1
immovable	अचल;स्थिर;अमिट;कठोर;दृढ;निर्दयी;स्थित;स्थिर;अचल;अटल;अडिग	-1
immoveable	अचल;अटल	-1
impassable	जान नसकिने;गहन;अगम्य;दुर्गम	1
impeccable	दोषरहित;निर्दोष;निष्कलङ्क;निष्पाप;स्वच्छ;त्रुटिरहित;अपाप;अवगुणरहित;त्रुटिहीन;निर्दोष	-1
impecunious	दरिद्र;गरीब;दरिद्र;निर्धन	-1
impetuous	प्रचण्ड;प्रबल;वेगसित चल्ने;अविवेकी;क्रोधी;तीव्र;प्रचण्ड;प्रबल;साहसी	-1
importunate	पटक पटक मागिरहने	1
impractical	अब्यवहारिक;अप्रयोगात्मक;अव्यवहार्य;अव्यावहारिक;असम्भव;असाध्य;कल्पित;अव्यवहारिक	-1
impressively	प्रभावशाली;प्रभावशाली ढङ्गले	1
inadmissibility	प्रवेशाज्ञा दिन नसकिने;अमान्यता	-1
inadmissible	स्विकार वा मन्जुर गर्न नमिल्ने;अग्रहण;अग्राह्य;अमान्य;अस्वीकार्य	-1
inalterable	बदल्न;साट्न नसकिने;अचल;अपरिवर्तनीय;स्थिर	-1
inapplicable	नसुहाउदो;अनुपयोगी;अनुचित;अनुपयुक्त;अप्रयोज्य;अयोग्य	-1
inapposite	असंगत;अयोग्य;अनुचित;अनुपयुक्त;अयोग्य	-1
inappropriate	अनुपयुक्त;अयोग्य;नसुहाउदो;अनुचित;अनुपयुक्त;अप्रयोज्य;अयोग्य;नामुनासिब;बेठीक	-1
inarticulate	स्पष्ट ब्यक्त गर्न नसकिने;व्यक्त गर्नमा अस्मर्थ;व्यक्त गर्नमा असमर्थ;अव्यक्त;अस्पष्ट	-1
incensed	धेरै रिसाएको;क्रोधित	-1
incommensurate	एकता वा समानता नभएको;भद्दा;बेडौल	-1
incommode	जिस्क्याउनु;बाधा पार्नु	-1
incompressible	थिच्न नसकिने;कडा;विशाल	-1
incongruity	अयोग्यता;नमिल्ने अवस्था;अनुपयुक्तता (f);अयोग्यता;असङ्गति (f);विषमता (f)	-1
incontestable	निर्विवाद;निसन्देह;अविवाद्य;निर्विवाद;प्रत्यक्षतः;सत्य	-1
incorrect	अशुद्ध;बेठिक;अनुचित;अयथार्थ;अशुद्ध;असत्य;गलत	-1
incredulous	शंका गर्ने;विश्वास नगरने;अविश्वासी	-1
indigestible	पचाउन नसकिने;पचाउन नसकिने;पचाउन नसकिने	-1
indigestion	अपच;अजीर्ण;अपच (m)	-1
indignity	अपमान;तिरस्कार;अनादर (m);अपमान (m);क्रोध;तिरस्कार (m)	1
indivisible	अभिभाज्य;भाग नहुने;अभाज्य;अविभाज्य;भाग गर्न अयोग्य	-1
induced	प्रेरित	-1
inexactitude	अपवित्रता;अशुद्धता;अनिश्चितता;अशुद्धता	-1
inexactness	अशुद्धता	-1
inexorability	निर्दयता;निष्ठुर्ता;अनवरत;कठोर;निर्दय;निर्दयी;निष्ठुर;निर्मम	-1
inexorable	नझुक्ने;अटल;कठिन	-1
infamous	कुख्यात;कलङ्कित;निर्लज्ज;बदनाम;कुख्यात;दुष्ट	-1
infatuated	मोहित गर्नु;लठ्ठ पार्नु;मूर्खता;उत्तेजित	1
infeasible	अव्यवहारिक;असाध्य;अव्यवहार्य;अव्यावहारिक	-1
infected	दूषित;संक्रमित;सन्दूषित;ग्रस्त	-1
infertile	रुखो;उब्जाउ नहुने;अनुप्जाऊ;अनुर्वर;निष्फल;बॉँझो	-1
inflated	फुलेको;घमण्डी;बढेको	1
inflexibility	कठोरता;अपरिवर्तनिय अवस्था;दृढता;कडापन (m);कठोरता (f)	-1
infuriating	रिस उठाउने	-1
ingenious	चलाख;जुक्ती निकाल्न खप्पिस;चतुर;चलाख;निपुण;प्रतिभावान;प्रवीण;शानदार;शुद्ध;सरल	1
inhumane	अमानवीय;निर्दयी	-1
injured	अपकृत;आहत;घायल;चोटग्रस्त;व्यथित	-1
innovative	प्रगतिशील;मौलिक;उन्नत;उन्नतिशील;नवप्रवर्तनशील;प्रगत;अभिनव;नवीन	1
inoperable	चिरफार गर्न नमिल्ने;अप्रभावी;निष्क्रिय;बेकार;विफल	-1
inopportune	कुबेलाको;कुसाइतको;असामयिक;असमयोचित	-1
insightful	ज्ञानमुलक;ठूलो पहुँच भएको	1
insolvent	निर्धन;टाट पल्टल्नु	-1
insomnia	निन्द्रा नलाग्ने रोग;अनिद्रा;निद्राभाव;अनिद्रा रोग	-1
inspirational	प्रेरणात्मक;प्रेरक;प्रेरणाप्रद;प्रेरणात्मक	1
inspired	प्रेरित गर्‍यो;उत्प्रेरित;प्रेरित;विभोर;प्रेरित हुनु	1
insubordinate	भनेको नमान्ने;नझुक्ने;अवज्ञाकारी	-1
insulting	अपमानजनक;गाली दिने व्यक्ति	-1
insuperable	जित्न वा हराउन नसकिने;अजेय;अलंघ्य;अविजेय;दुर्गम्य	-1
insurable	बिमा योग्य;बीमा-योग्य	1
insurmountable	जित्न नसकिने;अजय;अलंघ्य;अलङ्घनीय;अवश्य;दुरारोह;दुर्गम;दुस्तर	-1
insusceptible	असर नपार्ने;प्रभावहिन	-1
intangible	स्पर्श गर्न नसकिने;अप्रत्यक्ष सम्पत्ति;अमूर्त;अस्पष्ट;अस्पृश्य	-1
integrity	सम्पुर्णता;इमान्दारी;सफाई (f);समग्र;समेक;सम्पूर्ण;ईमान;सभ्यता(f);अखण्डता (f);अखण्डित्व;ईमानदारी (f);पवित्रता;पूर्णता (f);शुद्धता (f);सम्पूर्णता;साच्चोपन;सत्यनिष्ठा (f)	1
intellectual	बुद्धीजिवी;ज्ञानी;बुद्धिजीवी;बुद्धिजीवी व्यक्ति;बौद्धिक;मानसिक;बुद्धि विषयक;बुद्धि-सम्बन्धी	1
intestate	पत्ररहित;बिना वसीयतनामाको	-1
intolerable	सहन नसकिने;असहनीय;असह्म;असह्य;नसहने योग्य	-1
intransigence	कट्टरता (f);जिद्दी	-1
intransigent	झगडीया;कट्टर;कट्टर;सैद्धान्तिक	-1
intricately	अत्यन्तै मसिनो बुट्टाले;विस्तारपूर्वक	1
intriguing	पहेलीनुमा;आकर्षक	1
intrinsically	आन्तरिक रूपले;मूलभूत तरिकाले;सहज रूपले	1
invalid	रद्ध;नचल्ने;अस्विकार;अशक्त व्यक्ति;अपाहिज;दुर्बल;बलहीन;रोगी;कम्प्यूटरको लागि  अपरिचित;अमान्य;अविधिमान्य;अशक्त	-1
investigator	जाँच कर्ता;अनुसन्धाता;अन्वेषक (m);खोजी (m);जाँच गर्ने व्यक्ति	1
inviting	मन्मोहक;आकर्षण गर्ने;लोभाउनु	1
irreducible	घटाऊन नसकिने;अपरिवर्तनीय;अलघुकरणीय	-1
irrefutable	खण्डन गर्न नसकिने;अखण्डनीय;अटूट;निरूत्तर	-1
irrelevant	असम्बद्ध;असंगत;विसंगत;अप्रासंगिक;असंगत;असम्बद्ध;निष्फल;बेजोड;बेमतलब;बेलगाव;व्यर्थ	-1
irritated	उग्र;कुपित;क्रुद्ध;चिडचिडाहट	-1
itchy	लुतोबाट पीडित;बेचैन;व्याकुल	-1
jaggedness	तीखोपन;खुरखुरा	-1
jaundiced	डाही;पक्षपातपूर्ण;ईर्षापूर्ण;विकृत विचार	-1
jerking	झट्का	-1
jest	ठट्टा गर्नु;;हासो;ठट्टा;मजाक (m);हाँसो;उपहास	1
jesting	हाँसो;उपहास;ठट्टा;मजाक	1
jobless	बेगारी;काम नभएको;बेरोज्गार;बेकार;बेरोजगार	-1
jocose	ठट्यौलो;हास्यपूर्णता;रसिक;चुलबुले;विनोदी;हास्यपूर्ण;चन्चल	1
jocular	रसिक;रमाइलो;ठट्टाबाज;परिहासक;परिहासशील;हास्यकर	1
jocund	फरासिलो;प्रसन्न	1
joking	जिस्कनु;मजाक गर्नु	1
jolliness	मस्ती (f)	1
jollity	मोजमज्जा;खुशीयाली;आन्नद;उल्लास;खुशी;चहलपहल;प्रसन्नता;मस्ती (f);विनोद	1
jolly	आनन्दमय;प्रफुल्ल;विनोदपूर्ण;आनन्दित;प्रफुल्ल;प्रसन्न;मिलनसार;विनोदशील;विनोदी;सुन्दर	1
jolting	झट्काल्दै;बेस्सरी हल्लाउदै;आघात;झटका	-1
jovial	प्रफुल्ल;आनन्दित;आनन्दित;उल्लासपूर्ण;खुशी;प्रसन्न;प्रसन्नचित	1
joviality	प्रफुल्लता;हर्ष;आनन्द;प्रसन्नता (f);विनोदप्रियता;हँसमुख स्वभाव	1
judicious	ज्ञानी;विवेकवान;उचित;न्यायसङ्गत;न्यायसम्मत;प्रज्ञ;बुद्धिमान;विवेकपूर्ण;विवेकी;विवेचित;समझदार;सविवेक	1
judiciousness	दूरदर्शिता (f)	1
just	भर्खरै;उचित;ठीक तरिकाले;उचित;यथार्थ;ठीक;शुद्ध;सच्चा;धार्मिक;सही;न्याययुक्त;नियमित;नजिक;पूर्णतया;मात्र;केवल;शायद;ठीकठाक	1
justifiable	न्यायोचित;उचित;उचित;क्षम्य;तर्कसङ्गत;न्यायसङ्गत;रक्षणीय;शोधनीय;समर्थनीय;क्षमा योग्य	1
kind	दयालु;उपकारी;प्रकार (m);प्रकृति;वर्ग (m);वस्तु (f);स्वभाव (m);बदलामा वस्तु;जाति (f);नम्र;राम्रो;कृपालु;दयालु	1
kind-hearted	दयालु	1
kindhearted	सामाजिक;उदारहृदय;कृपालु;दयालु	1
kindliness	दयालुता (f)	1
kindly	दयापुर्वक;कृपासाथ;अनुकूल;कृपालु;दयालु;भद्र;मनोहर;सुखद;कृपया;कृपापूर्वक	1
kitsch	उत्ताउलो वा अश्लील साहित्य वा चित्र	-1
know	जान्नु;चिन्नु;थाहा हुनु;अनुभव हुनु;चिन्नु;चिन्नु;थाहा हुनु;अनुभव हुनु;थाहा हुनु;सम्झाउनु;परिचित हुनु	1
know-how	अनुभव (m);जानकारी (f);प्राविधिक जानकारी	1
knowable	जान्न वा चिन्नयोग्य	1
kudos	गौरव;मान;प्रशन्सा (f);यश	1
kwashiorkor	बच्चाहरूलाई हुने बिरामी	-1
laic	सांसारिक;भौतिक;साधारण	-1
large-hearted	उदार	1
large-minded	सहनशील;सहिष्णु	1
laud	तारिफ गर्नु;भक्ती गर्नु;प्रशंसा (f);स्तुति (f);भजन;प्रशंसा गर्नु;गुण गाउनु	1
laudable	तारिफयोग्य;प्रशंसा योग्य;प्रशंसनीय;गुण गाउने योग्य	1
laughable	हासोउठ्दो;उपहासपूर्ण;मनोरन्जक;हास्यकर;हास्यास्पद	1
laureate	चर्चित मान्छे;प्रख्यात;राजकवि (m);पुरस्कार विजेता;पुरस्कृत व्यक्ति;प्रतिष्ठित	1
lay	लम्पसार पर्नु;उत्तानो पर्नु;राख्नु;अण्डा दिनु;दफना दिनु;दाउमा  लगाई दिनु;शर्त (f);अस्तर (m);सम्भोग (m);कतार (f);लघु लिरिक्स वर्णनात्मक कविता;साझा (f);गीत (m);धूलमा मिल्नु;दाउ (m);योजना तैयार गर्नु;पर्त;पेस गर्नु;नक्शा (m);पसार्नु;पेस गर्नु;आधारशिला राख्नु;अण्डा दिनु;रूप रेखा बनाउनु;लागू गर्नु;मार्नु;पेश गर्नु;राख्नु;दाउ लगाउनु;लगाउनु;स्थापित गर्नु;दफना दिनु;गिरा दिनु;बल दिनु;अव्यवसायिक;गृहस्थ सम्बन्धी;सामान्य जन सम्बन्धी	-1
layman	सामान्य मनिस;गृहस्थ (m);जन साधारण (m);सामान्य जन	-1
layperson	जन साधारण (m)	-1
lecherous	कामुक;लम्पट;कामुक;भ्रष्टाचरण	-1
lenitive	पचाउने र दिशा नरम पार्ने औषधी	-1
leprosy	कुष्ठरोग;सोरायसिस;कुष्ठ;कुष्ठरोग	-1
letdown	अपमानित गर्नु;अपकार;अपमान;निराशा (f)	-1
level-headed	शान्त	1
liar	जाली;झुठो;मिथ्याबोल्ने;झूटो;मिथ्यावादी;झूटो बोल्ने	-1
life-and-death	कडा	1
light-hearted	प्रसन्नचित;गम्भीरता रहित	1
limitlessness	असीमितता (f)	-1
livable	जिउन लायक;बाँच्न योग्य;निवास गर्ने योग्य;रहने लायक;बस्न योग्य	1
liveable	जिउन लायक;बाँच्न योग्य;बस्न योग्य	1
load-bearing	भारयुक्त	1
logicality	तार्तिक;तर्क संगत	1
long-suffering	सहनशीलता	-1
longed-for	ईच्छित	1
lost	हराएको;नासिएको;गुमेको;एकाग्र;गुम;हाराएको;डूबेको;अलग गरिएको;खाएको;हराएको;अचेत;अदृष्ट;अलोप;नष्ट;लुप्त;हैरान;गायब	-1
lousy	जुम्रा परेको;घ्रिणित ब्यक्ती;धेरै खराब;भद्दा;घटिया	-1
lovable	प्रेम गर्न योग्य;प्यारो;प्यारो;काम्य;प्यार करने योग्य;प्रणेय;अनुराग्य;प्रेमयोग्य	1
love	माया;प्रेम;प्रिती;स्नेह;सुभगता;प्रेम (m);मुहब्बत (f);रुचि (f);लय;शून्य (m);स्नेह (m);इश्क (m);लगाव हुनु;चाह (f);इश्क़ (m);कामा;देशप्रेम होना;पसन्द (f);प्रनय;प्यार (f);प्रेमभाव (m);प्रणय (m);मोहब्बत;प्रियतमा (f);वफा (f);प्रीति (f);वात्सल्य (m);धेरै चाहानु;पसन्द गर्नु;माया गर्नु;पसन्द आउनु;पसन्द गर्नु;प्रेम गर्नु;स्नेह राख्नु;लगाव हुनु;चाहानु;देशप्रेम हुनु;प्रीतिकर;आदर्श;घनिष्ठ	1
loveable	प्यारो;माया गर्ने योग्य	1
loveliness	प्यारो;सुन्दरता;मनोरमता	1
lovelorn	प्रेमी;प्रेमीद्वारा छोडिएको;प्रेममा छोडिएको	-1
lovely	राम्रो;सुन्दर;सौम्य;मन्जु;मन्जुल;मनोज्ञ;आनन्ददायक;प्यारो;प्रिय;मनोरम;मनोहर;सुन्दर;सुन्दर;सुभग;सुहावना	1
loving	प्रिय;प्यारो;प्यारो;प्रेममय;स्नेहमय;स्नेही	1
luckless	अभागी;भाग्यहिन;अभागी;हतभागी/भाग्य	-1
lucky	भाग्यमानी;शुभ मौका पाएको;सफल;सुदृष्ट;नक्षत्रीय;सुकृत;सुलक्षण;खुशबख़्त;नसीबवर;भाग्यवान;भाग्यशाली;शुभ	1
lucrative	लाभदायक;नाफा हुने;लाभकर;लाभदायक;लाभप्रद;धनदायक;फाईदाको	1
lugubrious	शोकपूर्ण;शोकग्रस्त;उदास;दुखपूर्ण;विष;विषादमय;शोकाकुल	-1
lugubriousness	दुखपूर्णता;विषादमयता	-1
lumber	वाधा दिनु;थोत्रा कामनलाग्ने सरसामान;काठकाट्नु;काठ;दाउरा;दाउरा काट्नु;जम्मा गर्नु;थुप्रो बनाउनु	-1
lust	तिब्र काम बासना;काम प्रवृत्ति;उत्कट इच्छा;अभिलाषा;काम-वासना;कामुकता (f);लालच (m);लालसा;लिप्सा (f);लोभ;काम भोगको इच्छा गर्नु;लोभ गर्नु	1
lusty	तन्दुरुस्त;स्वस्थ;कामुक;जोरदार	1
luxurious	विलासी;आनन्द रुचाउने;भव्य;विलासमय;विलासी;विषयासक्त;शानदार;आनंदपूर्ण;किम्ती;अत्यलंकृत;आनन्द;आरामदेह;प्रचुर	1
maestro	संगितगुरु;आचार्य;उस्ताद (m);कलाकार;विशेषज्ञ;संगीतज्ञ	1
magnanimous	उदार वा ठुलो ह्रिद्य भएको;उदार;महानुभाव	1
maintainable	अनुरक्षणीय;पोष्य	1
maintained	जगेर्ना गर्नु;जोगाएर राख्नु;पोषित	1
majestic	शानदार;भब्य;ऐश्वर्यपूर्ण;प्रभावशाली;भव्य;विभूतिमान;शानदार;राज योग्य;आलीशान;तेजस्वी;प्रतापवान;प्रतापी	1
malaise	असजिलोपन;कष्ट;अस्वस्थता (f);बेचैनी (f);रुग्णता (f);क्लान्ति	-1
maleficent	अपराधी;हानिकर;अहितकर;हानिकर;अपराधशील;अपराधी;अशुभ	-1
maliciousness	द्वेष (m)	-1
malnourished	कुपोषित	-1
malodor	दुगर्न्ध;फोहोर	-1
malodorous	दुर्गन्धी;दुर्गन्धित	-1
mama	आमा	1
mamma	आमाको  स्तन	1
manageability	व्यवस्थित गर्न सकिने वा नियन्त्रण गर्न सकिने;प्रबन्धियनता	1
manifest	देखाउनु;प्रदर्शन गर्नु;व्यक्त गर्नु;स्पष्ट पार्नु;घोषणापत्र;समानसूची;स्पष्ट रूपमा देखिनु;प्रकट गर्नु;प्रकाशित गर्नु;प्रदर्शित गर्नु;साबित गर्नु;स्पष्ट गर्नु;दोषी;प्रत्यक्ष;व्यक्त;सफा;सुन्दर;सुबोध;स्पष्ट	1
mannerly	भद्र;शिष्ट;शिष्ट;सुशील;विनीत	1
marasmus	शरीरको क्षय;शरीर सुक्नु	-1
marvel	चकित पर्नु;आश्चर्यजनक व्यक्ति (m);आश्चर्य (m);चमत्कार (m);आश्चर्यमा पर्नु;अचम्भित हुनु;आश्चर्य गर्नु;अचंभित हुनु;आश्चर्य चकित हुनु	1
masterful	मन्परी गर्ने;हैकम चलाऊने;कुशल;ढीठ;तानाशाही;धृष्ट;निपुण	1
masterly	अद्वितीय;उत्तम;चतुराई	1
meagre	थोरै;अल्प;कमजोर;दुब्लो पातलो	-1
meddling	खिचलो;छेडछाड;हस्तक्षेप	-1
meek	नम्र;कोमल;अहङ्काररहित व्यक्ति;आज्ञाकारी;कोमल;नम्र;मृदु;विनीत;निरहङ्कार;विनम्र;विनयपूर्ण	1
meet	भेट्नु;मिल्नु;सभा (f);सम्मेलन (m);परिचय गर्नु;प्रतियोगिता;भुग्तान गर्नु;अनुभव गर्नु;परिचित हुुनु;पूरा हुनु;पूरा गर्नु;स्पर्श गर्नु;उत्तर दिनु;सुविधाको;उचित;उपयुक्त;ठीक	1
melancholia	उदासिनता;विषादरोग;उदासी;विषाद;विषाद-रोग	-1
melancholy	खिन्न;दिक्दार;गहिरो उदासी;अवसाद;उदासी (f);निराशा (f);विषाद (m);सुस्ती;खिन्नता;उदासीको अवस्था;उदास;खिन्न;निराश;निराशाजनक;सुस्त	-1
mellifluous	मधुर चिप्लो;महसम्बन्धी;मधुर;मृदुमन्द;सुमधुर	1
melodious	सुरिलो आवाज भएको;सुरिलो;मधुर;रसीलो;श्रुतिमधुर;सुरीलो;सुस्वर;मीठो शब्दको;कोमल;नम्र	1
menacing	डरलाग्दो;धम्काउने व्यक्ति;धम्की-भरि	-1
meningitis	मस्तिष्कको जाली सुन्निने रोग;मस्तिष्क ज्वरो	-1
merciful	दयालु;क्षमाशिल;अनुग्राही;करुणाशील;कृपालु;दयालु;सदस्य;सौभाग्यपूर्ण	1
merit	योग्य हुनु;खुबी देखाउनु;नाम कमाउनु;योग्यता (f);विशेषता (f);श्रेय;श्रेष्ठता;खुबी;उत्कृष्टता (f);खूबी;गुण (m);गुणवत्ता (f);धर्म;भलाई;महत्व (m);प्राप्त गर्नु;योग्य हुनु;पात्र हुनु;अधिकार पाउनु;लायक हुनु;पाउनु	1
merriment	आनन्द;खुशी;आनन्द;उत्सव;चहलपहल;मजाक;विनोद	1
meticulous	अती सावधान;अतिसावधान;कुशल;चेतन्य;छिद्रान्वेषी;सतर्क;सूक्ष्म;सूक्ष्माता	1
mildness	उदारता (f);कोमलता (f);दयालुता	1
mimetic	नकल गर्ने	1
mincing	नाजुक	1
mindful	सावधान;सचेत;सावधान;होशियार;सचेत	1
mirthful	आनन्दित;मनोरञ्जक;प्रसन्नतापूर्वक	1
misbehavior	अवगुण;दुराचार;अभद्र व्यवहार (m)	-1
misbehaviour	दुर्ब्यवहाँर;कुआचरण	-1
mischance	दुर्भाग्य;विपती;असफलता;दुर्घटना;दुर्भाग्य (m)	-1
mischief-making	चकचक;चकचक गर्नु	-1
misdirect	गलत बाटो देखाउनु;पथभ्रष्ट गर्नु;गुमराह गर्नु;गलत बाटो देखाउनु;अशुद्ध बाटोमा हिड्नु	-1
misguide	खराब बाटो देखाउनु;बहकाउनु	-1
mishap	दुर्भाग्यबस भएको घटना;आपत्ति (f);दुर्घटना (f);दुर्भाग्य (m);अभाग्य	-1
mislead	कुबाटोमा लैजानु;धोका दिनु;भटका दिनु;गलत मार्ग देखाउनु;पथभ्रष्ट गर्नु;बहकाउनु;भटक्नु;भुलाउनु	-1
misleadingly	भ्रामक रूपमा	-1
mismatched	बेमेल	-1
mistreat	गाली दिनु;दुर्व्यवहार गर्नु;नराम्रो व्यवहार गर्नु;गलत व्यवहार गर्नु	-1
misunderstand	गलत बुझ्नु;गलत समझ्नु;केहिको केहि समझ्नु	-1
model	आदर्श;नमुना;प्रतिरुप;नाप (m);प्रतिदर्श (m);प्रतिमा;प्रतिमान (m);प्रतिरूप (m);बानगी;आकार (m);आदर्श (m);मण्डल (m);तन्त्र;नक्षा;नमूना (m);बनाउनु;तैयार गर्नु;बनाई दिनु;ढाल्नु;रूप दिनु;साँचो बनाउनु;नमूना बनाउनु;नयाँ	1
mom	आमा (f);माता (f)	1
momma	आमा	1
mommy	ममी (f);आमा (f)	1
moneymaking	लाभकारी	1
moralistic	नैतीकतासम्बन्धी;नैतिकता;शिक्षा प्रद	1
mournful	दुखित;शोकपूर्ण;दुखी;उदास;विषादपूर्ण;शोकयुक्त	-1
mourning	शोक मनाउने वा बरखी बार्ने काम;शोक (m);गर्मीको पोशाक;शोक सूचक वस्त्र;उदासी;विलाप (m)	-1
mummy	संरक्षित मुर्दा;माता;आमा;मसाला इत्यादि लगाएर राखिएको लाश;पुरानो परिरक्षित शव;ममी (f);आमा;माता;मम्मी	1
mussy	अव्यवस्थित	-1
must	पक्का हुनु;अवश्य;आवश्यक हुनु;अनिवार्य हुनु;अनिवार्य;जरूरी	1
mutable	अस्थिर;चन्चल;अस्थायी;अस्थिर;परिवर्तनशील;परिवर्तनीय;बदल्न योग्य	1
mutter	सानो स्वरमा बोल्नु;गुनगुनाउनु;बडबडाहट (f);भुनभुनाहट;गुनासो  (f);फुसफुसाहट (f);बडबडाउनु;बिस्तारै -बिस्तारै बोल्नु;गर्जनु;बुदबुदाउनु	-1
nagging	गनगन गर्ने;क्रोधि	-1
narcissism	आत्मगौरब;अहङ्कार	1
narcolepsy	निद्रारोग	-1
nasty	मलिन;फोहोर;घिनौनी;घृणास्पद;दुष्ट;निर्लज्ज;नीच;नराम्रो;भयानक;अप्रिय;भारी;अश्लील;मैलो;कठोर;शैतान;कमीना;जबरदस्त;खतरनाक;खराब;फोहोर	-1
nearby	आसपास;नजिक;आसपास	-1
necessitous	अभावग्रस्त;दरिद्र	-1
negatively	गलत तरीकाले;नकारात्मक रूपले;नकारात्मक रूपमा;ऋणात्मक ढङ्गमा	-1
negativism	नास्तिवाद	-1
neighborly	मित्रवत;मित्रतापूर्ण;मित्रता	1
neighbourly	घर छिमेकजस्तो मिलनसार	1
nerve-racking	तनावपूर्ण;मानसिक दबाव भएको	-1
nerve-wracking	तनावपूर्ण	-1
neurasthenia	नसाहरुको दुर्बलता वा कम्जोरी;नसाको कमजोरी	-1
nice	असल;राम्रो;शरीफ;रमणीय;राम्रो;सहदय;शिष्ट;आनन्ददायी;सुन्दन;सभ्य;आलीशान;मात्रा विचारी;सुखद;उम्दा;कठिन;सुहावना;कोमल;सूक्ष्म;ठीक-ठाक;स्वच्छ	1
nifty	छरितो;छरीछाँटको;प्रशस्त;उपयोगी;कौशलपूर्ण	1
nisi	स्न्यथा;यावत;नत्र;पहिलेको	-1
no-go	गतिरोध	-1
non	अभाव वा नहुदो पन्को अर्थ बुझाउने उपसर्ग;गैर	-1
noncommercial	गैर वाणिज्यिक	-1
nonconforming	चलन चल्ती र परम्परा बिपरित खासगरी धर्म कर्म को बारेमा	-1
nonconformist	चलिआएको प्रथा या विश्वास लाई नमान्ने या भिन्न विचारधारा भएको;सम्प्रदायवादी	-1
noncurrent	अप्रचलित	-1
nonesuch	आदर्श (m);नमूना	1
nonexistent	अवास्तविक	-1
nonmoving	रोकिएको	-1
nonresident	प्रवासी	-1
nonsensical	निरर्थक;मूर्खतापूर्ण;अर्थहीन;अतर्कसङ्गत	1
nonsuch	अनुपम व्यक्ति या वस्तु;उदाहरण;अनुपम;आदर्श (m);नमूना	1
nonunionized	असङ्गठित	-1
nonviable	अलाभकारी;अव्यवहार्य	-1
not	हैन;हुन्न;होइन	-1
notorious	चर्चित;नराम्रो काममा पोख्त;कुख्यात;कुप्रसिद्ध;प्रकाशित;बदनामी;विख्यात;लोक प्रसिद्ध	-1
nudism	नग्न हुनु प्राकृतिक र स्वास्थ्यकर हो भन्ने एक सिद्धान्त;नग्नतावाद (m);नग्नवाद (m)	-1
objectionable	आपत्तिजनक;अनुचित;आपत्तिजनक;निन्दनीय;विवादास्पद;निन्दास्पद	-1
obliging	कृपालु;परोपकारी;भद्र;सुशील;शिष्टाचार युक्त;अनुग्रहकारी;अनुग्राहक;उपकारशाली;उपकारी;ऋणी	1
obnoxious	आपत्तिजनक;अपमानजनक;आपत्तिजनक;घृणित;नराम्रो;घिन लाग्दो;अप्रिय	-1
obscene	निर्लज्ज;अश्लील;अशुभ;अश्लील;अश्लीलता;घिनौना;घृणित;निर्लज्ज	-1
obtainable	प्राप्त गर्न सकिने;अभिप्राप्य;प्राप्य;पाउने योग्य;हासिल गर्न योग्य	1
occult	गुप्त;रहस्यमाय;तन्त्र-मन्त्र;अदृश्य;गुप्त;रहस्यमय;लुकेको	-1
oedema	पानी या पीप जमेर सुन्निएको;मेदासहित तन्तुको सुनिएको अवस्था	-1
off-street	सामान्य बाटो भन्दा अलग;सामान्य बाटो भन्दा अलग	-1
okay	राम्रो;ठीक;अनुमति;अनुमोदन;प्रशङ्सा;अनुमति दिनु;राजी हुनु;ठीक	1
ophthalmia	एक प्रकारको आँखा फुल्ने रोग	-1
opposable	विरोध योग्य;अवरोध्य	1
opprobrious	कडा आलोचना;अपमानजनक;निन्दात्मक	-1
oppugn	विरोध गर्नु	1
opulent	धेरै धनी;धनाढ्य;धनी;भव्य;शानदार;समृद्ध;वैभवपूर्ण;भरिएको	1
orchitis	अण्डकोषको शोथ	-1
out-and-out	सम्पूर्ण;पूरा	1
outlawed	गैरकानूनी घोषित गरिएको;अवैध बनाइएको;गैरकानूनी	-1
outlined	सीमाङ्कित	1
outsider	बाहिरको मान्छे;अगन्तुक;परदेशी;गैर;बाहिरी व्यक्ति (m)	-1
overstate	बढाइ चढाइ कुरा भन्नु	1
pacify	शान्त पार्नु;मेल गराउनु;ठहराउनु;दबाउनु;मनाउनु;शान्त बनाउनु;दमन गर्नु;सन्तुष्ट बनाउनु;शान्ति स्थापित गर्नु;मेलमिलाप गर्नु	1
pagan	कुनै धर्म नजान्ने ब्यक्ती;अधर्मी;नास्तिक;प्रतिमापूजक;मूर्तिपूजक (m);गैर-ईसाई;मूर्ख	-1
palsied	कम्पित;पक्षाघात बाट ग्रस्त;थरथराउदै	-1
paranoia	मानसिक उन्माद;एक किसिमको पागलपन;पागलपन;व्यामोह;सम्विभ्रम (m)	-1
paraplegic	कम्मर देखी मुनी पक्षघात भएको ब्यक्ती;शरिरको तल्लो आधा भागको पक्षघात	-1
paresthesia	अपसंवेदन	-1
parsimonious	मितब्ययी;कन्जुस;कमखर्ची, मितव्यय, बद्धमुष्टि,;कञ्जूस;कमखर्ची;तुच्छ;थोरै;दरिद्र;मितव्ययी;किफायती	-1
pasteurization	मुक्त गराउने तरिका वा विधी	-1
patchy	टालेको;छाटकाट नमिलेको;विचित्र;विविध;तुनुकमिजाज;ठीकले नगरिएको;पैबन्द वस्तु;अपूर्ण;गड्ड-बड्ड;चिडचिडा;दुष्ट	-1
pathos	मायादया उब्जाउने चिज;असर (m);जोश (m);प्रोत्साहन;मनोभाव (m);हौसला;ग्रहणशीलता;करुणा	-1
paucity	कमी;घटी;अभाव (m);अल्पता (f);कमी (f);न्यूनता;लघुता	-1
peachy	अति राम्रो;विलक्षण;शानदार;विशिष्ट;उत्कृष्ट	1
pediculosis	जुम्रा पर्नु;जुम्रे;युकापूर्ण	-1
peeve	वाक्क पार्नु;दिक्क लगाउनु	-1
pejorative	अपमानजनक;तुच्छ बनाउनेवाला	-1
pellagra	खानामा निकोटिनिक एसिड को कमीले हुने एक रोग	-1
perceptible	जान्न बुझ्न सकिने;महसुस गर्न सकिने;इन्द्रियगोचर;दृष्टिगोचर;प्रत्यक्ष;महसुस;सुस्पष्ट;स्पष्ट;इन्द्रिय ग्राह्य	1
perfect	पूर्ण;ठीक;;परि;गर्नु;पुरा गर्नु;सिद्ध गर्नु;सुधार गर्नु;परिपूर्ण गर्नु;निपुण गर्नु;बढाउनु;निपुण बनाउनु;सुधार्नु;निर्दोष;निष्कलंक;परिपूर्ण;पूरा;पूर्ण;पूर्णकालिक;सम्बन्धी;अचूक;सम्पन्न;सम्पूर्ण;उचित;उत्तम;सही	1
perfectible	पूर्ण गर्न सकिने;पुरा गर्न सकिने	1
permanent	स्थायी;स्थिर;कृत्रिम लट;स्थायी;स्थिर;टिकाऊ;दृढ;नित्य	-1
pernicious	हानीकारक;दुखदायी	-1
perplexed	जिल्ल परेको;ब्याकुल;अजीब;पेचीदा;भ्रान्त;मुग्ध;विकल;व्यग्र;हैरान;उलझेको;डराएको;किकर्तव्यविमुढ (n)	-1
perplexity	कुनै कठिन बिषय को बारेमा बुझ्न नसक्ने;झेल्न नसक्ने;सामना गर्न नसक्ने	-1
perspicacious	तिक्ष्ण बुद्धी;सुक्ष्म दृष्‍टि	1
pertinacious	हठी;जिद्धी;अटल	-1
phlebitis	स्नायु प्रदाह	-1
phlegmatic	अल्छी;शान्त;उदास	1
pious	धर्म मान्ने	1
piteous	दयनिय;मायालाग्दो	-1
pitiful	कोमल;निच;शोचनिय;दयार्द्र	-1
pity	दया;करुण;करुणा (f);तरस;दया (f);लज्जा (f);स्नेह (m);हमदर्दी (f);तरस खानु;दया गर्नु;दया राख्नु;हमदर्दी प्रकट गर्नु;पछुताउनु	-1
placable	सजिलै मान्ने;नरम स्वभावको	1
placate	शान्त पार्नु;सान्त्वना दिनु	1
plain	साधा;सम्म भूभाग;तराई;निस्तो;मैदान (m);रणभूमि (f);लडाईको मैदान (m);समभूमि (f);समतल क्षेत्र;समतल भूमि (f);सहज;बिना मसालाको;चौरस;सात्विक;सुबोध गम्य;निष्कपट;सादा;पूर्ण;साधारण;प्रकट;सफा;प्रत्यक्ष;सामान्य;सीधा;बिल्कुल;सुगम;भोला-भाला;स्पष्ट;साधा;सफा तौरमा;बिलकुल;स्पष्टतः;स्पष्ट रूपले;सफईले;सर्वथा	-1
plaudit	प्रशंसा;स्याबासी (f);थपडी;करतलध्वनि	1
plaudits	स्तुती;प्रशंसा	1
playable	नाटक गर्न योग्य;खेल्न योग्य;बजाउन योग्य	1
pleasant	रमाइलो;प्यारो;सुखद;सुहाना;हँसमुख;राम्रो लाग्नु;प्रीतिकर;मजेदार;मधुर;मनोहर;रुचिकर;रुचिर;रोचक;लोभाउनु;सुखकर	1
pleasantry	हसाउने कुरा;टिप्पणी;आनन्द;खुशी;प्रसन्नता;प्रमोद;हाँसो	1
plonk	सस्तो रक्सी;केही कुरा झरेको आवाज;सस्तो रक्सी;सुस्त बस्नु;हलुकासँग बस्नु	-1
plummy	लाभकारक;बयर भएको;बेस;असल;रहर लाग्ने	1
poignancy	तिब्रता;मार्मिक्ता;तीक्ष्णता (f);तीखापन (f);मार्मिकता (f)	-1
pointless	चुच्चो नपरेको;टुप्पो नभएको;निर्धार;बेकार;भोतर;व्यर्थ;बिना नोकको;अतीक्ष्ण;अनर्थक;अप्रस्तुत;अर्थशून्य;अर्थहीन;कुन्द;निरर्थक	-1
poliomyelitis	चम्कनु;पोलियो (m);पालिस गर्नु	-1
politeness	भद्रता (f);शिष्टता (f);शील;आदाब	1
poltroon	एकदम कातर	1
polyvalent	बहुसंयोजक;अङ्गराग	1
popularity	लोकप्रियता;प्रसिद्धी;आमपसन्द;प्रसिद्ध;प्रसिद्धि;लोकप्रियता (f);सर्वमान्यता (f);सर्व प्रीति	1
potable	पिउन हुने	1
poverty	गरीबी;अभाव	-1
praise	सराहना;प्रशंसा;तारिफ गर्नु;प्रशङ्सा (f);स्तुति (f);बढाइँ;कीर्ति (f);ख्याति;स्तुति गर्नु;प्रशङ्सा गर्नु;बढाइँ गर्नु	1
praiseworthy	तारिफ गर्न लायक	1
preciousness	बहुमुल्यपन	1
precise	सटिक;सही;ठीक;स्पष्ट;सहि;ठीक;निश्चित;यथार्थ;विधिपूर्वक;सूक्ष्म;स्पष्ट;विधि पूर्वक	1
preferable	उत्तम;उत्कृष्ट;श्रेष्ठ	1
preferred	रुचाएको;मन परेको;अधिमान्य;आधिमत;मुख्य;वरीयता प्राप्त	1
prejudge	छानबिन गर्नु;जाचबुझ गर्नु	-1
premium	विमाको किस्ता;उपहार वा पुरस्कारको रकम;किस्ता (f);नाफा (m);प्रीमियम;फल (m);बढौती;लाभ;लाभांश (m);बीमाको लागि दिएको रूपैयाँ;अधिमूल्य (m);उपहार(m)	1
preposterous	असंगत;नसुहाउदो	1
prestigious	इज्जतदार;प्रतिष्ठित;ख्यातिप्राप्त;गौरवमय;प्रतिष्ठापूर्ण;प्रतिष्ठित;गौरवपूर्ण	1
prettiness	सुन्दरता;लावण्य;आकर्षक	1
preventable	निरोधक;निवारक	1
priggish	घमण्डी;आत्मअभिमानी	1
prim	शिष्टाचार जानेको;सुहाउदो मिल्दो	1
primping	नक्कल पार्दै बस्नु;कपाल या श्रिंगार गरेर समय बिताउनु	1
principled	उच्च सिद्धान्तको	1
printable	छाप्न मिल्ने	1
prize	पुरस्कार दिनु;सम्मान गर्नु;निधि (f);पुरस्कार (m);प्रति-;सिद्धफल (m);बहुमूल्य वस्तु;जितेको वस्तु (m);धेरै दाम लगाउनु;महत्त्व दिनु;बहुमूल्य मान्नु	1
probationary	परीक्षणमा राखिएको	-1
probity	इमानदारी;सत्यनिष्ठा	1
proctalgia	मलाशयको पीडा	-1
profitability	लाभ्दायकता;लाभकारिता (f);लाभदायिकता;लाभप्रदता (f)	1
prolific	फलदायी;धेरै बच्चा जन्माउने;फलप्रद;बहुफल;सफल;प्रजावती;अनुकूल;उपजाऊ;उर्वर;उर्वरा;फलदार	1
prolixity	अल्छि लाग्दो भाषण	-1
promiscuous	धेरैसँग शारिरिक सम्बन्ध भएको	-1
propellant	घचेट्ने ब्यक्ती वा यन्त्र	1
propelling	कुनै दिशामा हाँक्नु या धकेल्नु खासगरी अगाडी	1
propriety	मर्यादा;औचित्य	1
prosperous	सम्रिद्ध;सफल;सम्पन्न;सुखी;यशवन्त;सम्पन्न;सफल;समृद्ध;सम्पन्न;सौभाग्यशाली;अनुकूल;खुशी;पूरा;भाग्यशाली	1
provable	साबित गर्न सकिने	1
prudent	सावधान;सतर्क;सावधान;चलाख;दूरदर्शी;न्याय;बुद्धिमान;मितव्ययी;विवेकी	1
prudish	भद्रता वा नम्रता देखाउने	1
pseudo	झुठो;नक्कली;मिथ्या	-1
psychotherapist	मनोवैज्ञानिक तरिकाले मानसिक रोगको उपचार गर्ने चिकित्सक	-1
pucker	चाउरी पार्नु;खुम्च्याउनु	-1
punctilious	सानो सानो कुरा मा धेरै ध्यान दिने;ठीक आचरण मा जोड दिने	1
purposefulness	कुनै खास उदेश्य भएको	1
putrefy	कुहनु;बिग्रनु	-1
quality	गुण;स्वभाव;लक्षण (m);विशेषता (f);शक्ति;स्वभाव (m);स्वरूप (m);आचरण;विशिष्ट लक्षण;उत्कृष्टता (f);श्रेष्ठ पद;उच्च कुलमा जन्म;गुण (m);धर्म (m);प्रकार (m)	1
quantifiable	संख्यात्मक ढंगले बर्णन गर्न सकिने	1
querulous	कचकच गर्ने;चित्त बुझाउने;झगडिया;झर्कने;विलापी;रुञ्‍चे;निहुँखोजाहा;अडिञ्‍चे (केटाकटी);कचकचे;फतफते;खिचखिचे;खिचोलापन	-1
quinsy	कंठमाला;कंठरोग	-1
quintessential	सर्वोत्कृष्ट	1
racking	अत्यन्त कष्टदायी;धम्की दिएर माग्नु;चलाखीको;जबरजस्ती माग्नु;बलपूर्वक माग्नु	-1
rainproof	पानीबाट बचाउने खालको	-1
rancid	कुहिएको;गन्हाउने;बासी भएर गन्ध आएको;बासी सडेको घ्‍यू वा बोसोको जस्तो स्वाद वा बास्ना भएको;उग्लेको;उग्रगन्धी	-1
randy	यौन उत्तेजना भएको;असभ्य ब्यक्ती;;भिक्षु;भिक्षुणी;मगन्त;भिकारी;कामोत्तेजित;ठूलो बोलीको;उत्ताउलो;बिच्केको;मात चढेको	1
ratiocinative	चिन्तन या सोचाइ सँग सम्बन्धित	1
rationality	ज्ञानशक्ती;तर्कशक्ती;तर्क शक्ति;तर्क युक्त;उपयुक्तता (f);चेतनत्व;चेतना;तर्क;न्यायता(f);विवेक (m);तर्कशक्ति;तर्कसङ्गत;तार्किकता (f)	1
rattling	तेज;तिब्र;अद्भुत;तेजस्वी;शीघ्र;शोभायमान;तेज;कोलाहलमय	1
ravishing	सुन्दर;मोहित पार्ने;आकर्षक;मोहक;सम्मोहक;मनछुने	1
reassured	आश्वासन दिईएको;आश्वस्त	1
recantation	आलोचना;खण्डन;अस्वीकार;इन्कार;तर्क;त्याग;प्रत्याहार (m)	-1
rechargeable	पुन: चार्ज गर्न लायक;पुन: चार्ज गर्न लायक	1
reconcilable	मिलाउन सकिने;अनुकूल;सङ्गत;समाधेय;मुताबिक;अविरुद्ध	1
reconstructive	पुनर्निर्माण गर्न मद्धत गर्ने	1
recyclable	पुनः चक्रित गर्न योग्य;पुनः चक्रित गर्न योग्य	1
red-blooded	तेजस्वी;नसली	1
redoubtable	अदम्य;ख्यात;प्रतिष्ठित;भयानक;विकट;महापराक्रमी;बढाइएको;बढाउन योग्य	1
reducible	घटाऊन सकिने;कम गर्न सकिने;घटाउन योग्य;बदल्न योग्य;कम गर्न योग्य;घटाउन योग्य;क्रममा लिन योग्य;छोटो बनाउन योग्य;पतलो बनाउन योग्य	1
refurbishment	नवीकरण;नवीकरण (m);नयाँ बनाउनु	1
regret	पछुताउनु;पश्चाताप;सोच;अफसोस (m);क्षमा(m);पश्चाताप दुख;दु:ख (m);क्षमा हुनु;पश्चात्ताप (m);रञ्ज;शोक (m);क्षमा गर्नु;शोक गर्नु;अफसोस गर्नु;क्षमा प्रकट गर्नु;दुःखी हुनु;उदास हुनु;रञ्ज गर्नु;पश्चात्ताप गर्नु;पछुताउनु;क्षमा हुनु	-1
relaxed	आरामदेह;ढीला;नर्म;शिथिल;निश्चिन्त;तनाव मुक्त	-1
reliability	विश्वसनिय;दृढता;विश्वसनीयता (f);विश्वस्तता;स्थिरता;मजबूती;विश्वासनीयता;विश्वास योग्यता	1
remorseful	पश्चाताप को भावना ले भरिपूर्ण	-1
reparable	मरम्मत गर्न सकिने;प्रतिकार्य;सुधार्य;मर्मत योग्य	1
repentant	पश्चाताप गर्ने;पश्चात्तापी (m);पापको पश्चताप गर्ने व्यक्ति;पछुताउने व्यक्ति	-1
repletion	भरीपूर्णता;परिपूर्णता;परिपूर्ति;संतृप्ति (f);परिपूर्ण हुनु;भरपूर्ण हुनु;भरिएको हुनु	-1
reprehensible	तिरस्कार गर्न योग्य;निन्दनीय;निन्दा;दोषारोपणगर्न योग्य;कलङ्कक;निन्दाको	-1
reproach	गाली गर्नु;निन्दा गर्नु;तिरस्कार;धिक्कार;निन्दा;बदनामी (f);कलङ्क (m);धिक्कारको वस्तु;नराम्रो भन्नु;धिक्कार्नु;गाली दिनु;दोष लगाउनु;तिरस्कार गर्नु;निन्दा गर्नु;बदनाम गर्नु	-1
reproof	गाली;घुर्की;असहमति (f);निन्दा	-1
reproving	आलोचनात्मक;निन्दात्मक	-1
repugnant	प्रतिकुल;विरक्तीकर;अरुचिकर;असंगत;घिनलाग्दो;घृणास्पद;प्रतिकूल;विरुद्ध	-1
reputable	नामी;इज्जतदार;विख्यात;सम्मानित;इज्जतदार;प्रतिष्ठा योग्य;आदरणीय	1
researcher	अनुसन्धानकर्ता;खोज्कर्ता;शोधक (m);शोधकर्त्ता (m);अनुसन्धानकर्त्ता (m);अन्वेषक (m)	1
resentful	क्रोधित;क्रोध शील;रिसाएको;क्रोधित;क्रोधी	-1
resolute	धिर;साहसी;द‍ृढ;स्थिर;स्थिर संकल्प;साहसी;सुनिश्चित;स्थिर;दृढप्रतिज्ञ	1
respectability	आदर;सम्मान;श्रद्धा;सम्मान;आदर योग्यता;प्रतिष्ठा (f);मान्यता;सत्कार	1
respectable	सम्माननिय;पूजनिय;योग्य;सन्मान;सम्मानित;इज्जतदार;प्रणम्य;वन्दनीय;सम्माननीय;इज्जतको योग्य;आदरणीय;धेरै राम्रो;मान्य	1
respected	आदरणीय;सम्मानित;सम्माननिय;श्रद्धास्पद	1
restless	छटपटी;अधीर;अशान्त;आतुर;चञ्चल;चिन्तित;व्याकुल;आकुल;छट्पटी;निद्रा रहित;विश्राम नगर्ने व्यक्ति	-1
retired	अवकाश प्राप्त;निवृत्त;सेवानिवृत्त;वकाश प्राप्त;शरण लिएको;अवकाश ग्रहण गरेको;व्यापार त्याग गरेको;सेवामुक्त गरिएको	-1
reusable	पुन: प्रयोग गर्न सकिने;पुन: प्रयोग गर्न योग्य;पुन: प्रयोग गर्न योग्य	1
reverence	भक्ती;श्रद्धा;आज्ञापालन (m);आदर (m);इज्जत (f);पूजा;भक्ति;श्रद्धा (f);सत्कार;सम्मान (m)	1
reverend	पूजानिय;पुज्य;श्रद्धेय;आदरणीय;पूजनीय;श्रद्धेय;सत्कार योग्य	1
reverent	श्रद्धा गर्ने;आदर गर्ने;नम्र;भक्तियुक्त;विनीत;श्रद्धापूर्ण;श्रद्धालु;सुशील;सम्मान सूचक	1
right-minded	न्यायसङ्गत विचार गर्ने व्यक्ति;समझदार;न्यायसङ्गत विचार गर्ने व्यक्ति;सही ढङ्गले विचार गर्ने व्यक्ति;ठीक दिमाग भएको	1
righteous	धार्मिक;आस्तिक;सिधा;ईमानदार;धार्मिक;न्यायसङ्गत;पवित्र;साँचो;साधु;न्याय परायण	1
righteousness	न्याय परायणी;धर्म;धार्मिकता (f);पवित्रता;सच्चाई;साधुता (f)	1
rightfulness	कानुनी अधिकार भएको	1
rosy	गुलाबी;सुगन्धित	1
rotten	कुहेको;गलेको	-1
rowdy	हुलदुङगा गर्ने;उपद्र्यहा	-1
ruffian	गुण्डा;निर्दयी मान्छे	-1
ruthless	निर्दयी;निष्ठुर	-1
sadly	दुर्भाग्यवश;उदासी;खराब तरिकाले	-1
sadness	उदासिनता;दुःख (m);निराशा (f);विषाद (m);शोक (m);विडम्बना;उदासी (f);गम्भीरता	-1
sagacious	चतुर;चलाख;चतुर;दूरदर्शी;निपुण;बुद्धिमान;समझदार;मेधावी	1
saintlike	धर्मात्मा;पवित्र;पुण्य;सिद्ध;साधु जस्तै	1
saintly	ॠषीमुनी जस्तो पवित्र;पवित्र;पुण्य;पुण्यात्मा;सिद्ध;साधु-सन्त जस्तै	1
salubrious	स्वास्थ्यकर;निरोगी राख्ने	1
salutary	हितकर;उपयोगी;स्वास्थ्यवर्धक;आरोग्यजनक	1
sanctimonious	धर्मअभिमानी;ढोङगी	1
sane	स्वास्थ्य;समझ्दार;मानसिक रूपमा स्वस्थ;मानसिक रूपमा स्वस्थ;निरोग;विचारशील;सन्तुलित;समझदार;स्वस्थ	1
sanguinary	घातक;हत्यारा	-1
sanguine	आशावादी	1
sanitation	सरसफाइको प्रबन्ध;आरोग्य विद्या;स्वास्थ्य विद्या;सफाई व्यवस्था;स्वच्छता (f)	1
sapient	ज्ञानयुक्त;बुद्धिमानी	1
sarcastic	ब्यंगात्मक;कटु;कटु;व्यङ्ग्यपूर्ण;व्यङ्ग्यात्मक;कटू	-1
saturnine	दिक्दार;खिन्न;शुन्य	-1
scabies	लुतो;एक प्रकारको चर्मरोग	-1
scabrous	शुष्क;खस्रो	-1
scorn	निन्दा गर्नु;हेला गर्नु;तिरस्कार (m);घृणा (m);हेला;खिसी;बिल्ला;घिन;घृणा लाग्ने वस्तुI;उपेक्षा;तिरस्कार गर्नु;हेला गर्नु;घृणा गर्नु;खिसी गर्नु;उपहास गर्नु;अस्वीकार गर्नु	-1
scrawl	हतारको लेखाइ	-1
scummy	फिज भएको फोहोर मैलोले भरिएको	-1
scurvy	तुच्छ;छुद्र	-1
seemly	सुहाउदो;उपयुक्त	1
selective	होसियारिपुर्वक छानिएको;वरणात्मक;चयनशील;चयनात्मक	1
self-respect	आत्मसम्मान (m);आत्म-सम्मान (m)	1
selfishness	स्वार्थपरायणता;स्वार्थपरता (f)	-1
selfless	निस्वार्थी;स्वार्थहिन	1
sensational	सनसनीपूर्ण;हलचल मच्चाउने	1
serendipity	कुनै योजना बिना अचानक भएको खुशीको घटना	1
sexy	कामोतेजक;कामुक;आकर्शक;सुन्दर;आकर्षक;कामुक;कामोत्तेज;उत्तेजित गर्ने;सुन्दर	1
shapely	सुन्दर रुप भएको;छाटकाट मिलेको	1
shoddy	नक्कली;काम नलाग्ने	-1
shrew	कचकच;गनगन;छुचुन्द्रो	-1
sincere	साचो;इमान्दार;राम्रो विचार;ईमानदार;निष्कपट;यथार्थ;वास्तविक;शुद्ध;साँचो;स्वच्छ;हार्दिक	1
sinful	पापी;अधर्मी	-1
sinister	अशकुन;अशुभ;अशुभ;कपटी;कुटील;बायाँ;नराम्रो;बेईमान;भयावह	-1
skilful	कुशल;कौशलपूर्ण;दक्ष;निपुण;प्रवीण	1
skilled	कुशल;सिपालु;अभ्यस्त;कुशल;कौशलपूर्ण;गुणी;चलाख;निपुण;प्रशिक्षित	1
skillful	सिपालु;दक्ष	1
smart	फुर्तिलो;चतुर;चलाख	-1
smashing	असाध्यै राम्रो;सुन्दर;आकर्शक	1
smelly	गन्धपूर्ण;वासयुक्त	-1
sneak	खुसुक्क भाग्नु;सुटुक्क जानु	1
sociable	मिलनसार;मैत्रीभाव भएको	1
soil	माटो;भूमि (f);मल (m);मलिनता;माटो (f);हिलो (m);खाद (f);फोहोर (f);देश (m);चिप्लो माटो (f);दाग (m);धरणी;धर्ती (f);गिलो माटो(f);प्रदेश;दूषित गर्नु;बदनाम गर्नु;फोहोर गर्नु;कलंकित गर्नु;दाग लगाउनु;अपवित्र गर्नु;खाद हाल्नु	-1
sometime	कुनै बेला;कहिलेकाही;पहिले;समय-समय;कहिले काहिँ;कुनै समयमा;कुनै समय;पूर्व समयमा	-1
sordid	लोभि;कन्जुस	-1
sore	कष्टजनक;पिडायुक्त;घाऊ;दाग;खटिरा;छाला संक्रमण;घाउ (m);सुकुमार;पीडादायक;उदास;चोट खाएको;कष्टप्रद;रिसाउनु;अत्यन्त;दुःखदायक रूपमा;धेरै	-1
sorrow	दु:ख;पिडा;शोक (m);संताप;अफसोस;पीडा;क्लेश;खेद (m);दु:ख हुनु;ज्वरो;व्यथा;खेद मान्नु;शोक गर्नु;उदास हुनु;दुःखी हुनु;दु:ख हुनु	-1
sound	ध्वनी;आवाज;स्वस्थ्य;ठीक;आवाज (f);आहट;कोलाहल;शब्द (m);घाउको गहिराइ नाप्ने यन्त्र;सलाई (f);ध्वनि (f);स्वर;अक्षत;राम्रो;निरोगी;तन्दुरूस्त;गहिरो;भारी;फुर्तिलो;ठीक;साँचो;समर्थ;तीव्र	1
specular	दर्पण जस्तो	1
spite	डाहा गर्नु;ईर्ष्या गर्नु;रिस;डाह;द्रोह;द्वेष;ईर्ष्या;विरोध;अनादर गर्नु;द्वेष गर्नु;जानीबुझी सताउने;निरास पार्नु;चिढ्याउनु;घृणा गर्नु;अपमान गर्नु;कष्ट दिनु	-1
splendid	भड्किलो;तेजस्वी;उज्वल;विराजमान;धूमधाम;भव्य;एकदमै राम्रो;उत्कृष्ट;उत्तम;चट्किलो;चमकिलो;चहकिलो;भड्किलो;विशाल;वैभवशाली;शानदार	1
sprain	मर्कनु;मर्काइ;मर्कनु;मर्काउनु;मर्मर्‍याउनु	-1
squalor	फोहोर;मैला	-1
squeezable	सजिलो सँग थिच्न मिल्ने	1
staid	गम्भिर;शान्त;शान्त;सन्तुलित;सौम्य;स्थिर;संयम;अचल;गम्भीर	1
stainless	खिया नलाग्ने	1
starless	तारा नभएको	-1
stealthy	अज्ञात;अप्रकाशित	1
stench	दुर्गन्ध;कुहीगन्ध;भभक;दुर्गध;गंदगी;दुर्गंध (f);दुर्गन्ध;बदबू	-1
sterling	सक्कली;बेलायतको मुद्राको नाम;स्टर्लिङ (m);अकृत्रिम;असली;उत्कृष्ट;पक्का;वास्तविक;विशुद्ध;शुद्ध	1
stew	उसिन्नु;पानीमा उमालेर पकाउनु;मस्तिस्कको गडबडी	-1
sting	चिल्नु;डस्नु;पोल्नु;जलन हुनु;कंटक;घाउ;चुभन (f);टीस (f);डस्नु (m);दु:ख (m);डंक मार्नु;जलन हुनु;काट्नु;डस्नु;दुःख;दुख्नु;प्रेरित गर्नु;दुखित हुनु	-1
stinging	घोच्ने;चिल्ने	-1
stoical	केही नभनी दु:ख पिडा झेल्ने वा खप्ने	-1
stoppable	रोक्न सकिने	1
stubborn	ढिपी गर्ने;अटेरी;जिद्दी	-1
stupid	मुर्ख;अबुझ;अचेत;जड;ढीला;फालतू;बेकार;बेवकूफ;बोदा;मन्द;मूर्ख;मूर्खतापूर्ण;सुस्त;मूढ	-1
suavity	कोमलता;नम्रता	1
sublime	विशिष्ट;उत्कृष्ट	1
successful	विजयी;सम्पन्न;सफल;सुगम;सौभाग्यशाली;कामयाब;कृतार्थ;प्रसन्न;प्रारब्धवान	1
suffering	दु:ख;कष्ट;आपत्ति (f);कष्ट (m);क्लेश;दुःख (m);पीडा (f);भोग;यन्त्रण;पीडित;अत्यन्त दुखी	-1
suit	मिलाउनु;अनुकुल बनाउनु	1
suitability	योग्यता;दक्षता;अनुकूलता (f);अनुरूपता;उपयुक्तता (f);तुक;मेल;योग्यता (f)	1
sumptuous	भब्य;धेरै मुल्य पर्ने	1
sunk	डुब्यो	-1
superb	उत्कृष्ट;भब्य;शानदार;कान्तिमान;धेरै राम्रो;उत्तम;क्रान्तिवान;देखाउ;धनी;प्रतापवान;भव्य	1
superfluous	चाहिदो भन्दा बढी;अनावश्यक;अतिरिक्त;अनावश्यक;निरर्थक;फालतू;जरूरत भन्दा धेरै	-1
superiority	श्रेष्ठता;विशीष्टता;प्रधानता (m);वरिष्ठता;विशिष्टता;श्रेष्ठता (f);सुविधा (f);उच्चता (f);उत्कृष्टता (f);गुरुता (f)	1
superlative	अत्युत्तम;सर्वोत्तम	1
superstitious	भुतप्रेत्मा विश्वास गर्ने	1
surly	असभ्य;अभद्र	-1
surpassing	उछिन्ने;उत्कृष्ट	1
surprising	चकित पार्नु;आश्चर्य लाग्ने;आश्चर्यजनक;विचित्र	-1
sustainable	दिगो;सहनिय	1
swell	पेट बोक्नु;फुल्नु;लहर (f);चढाइ (m);वृद्धि (f);तरङ्ग (f);आकार वा ध्वनिको वृद्धि;फूल्नु;सुनिनु (f);बढाउनु;मोड्नु;हावा भर्नु;प्रफुल्लित गर्नु;बढ्नु;अधिक गर्नु;उत्तम;अलबल्ले;सुनिएको;सजिएको;सुन्दर	1
swoon	मुर्छा पर्नु;अचेत हुनु	-1
taking	उत्तेजना (f);ग्रहण (m);धारण;व्यापारमा लिइएको मुद्रा;सजिलैसँग पाइनु;आकर्षक;मनोहर;मोहिनी;रम्य;लोभलाग्दो;ग्रहण गरिने;मोहक	1
tardiness	ढिलो गर्ने बानी;अल्छिपन	-1
tasteful	मिठो;मनपर्दो;कौशल युक्त;मनोहर;रुचिकर;सुस्वाद;स्वाद;स्वादिष्ट;सुस्वादु	1
tearfulness	दु:ख ब्यक्त गर्न रुने	-1
terrifying	आतंकित गर्नु;डर त्रास देखाउनु	-1
therapeutic	चिकित्सा विज्ञानसम्बन्धी	1
thorough	पूर्ण;पुरा;निःशेष;पूरा;पूर्ण;विस्तृत;सम्पूर्ण	1
ticklish	कुत्कुती लाग्ने;कठिन	-1
tingle	झुरो;चर्चराउनु;सुकेको दाउरा	-1
tomfool	मुर्ख ब्यक्ती	1
torment	सताउनु;कष्ट दिनु;सन्ताप;उत्पीडन (m);दुखदाई वस्तु;अभिशाप (m);कष्ट;पीडा (f);यातना (f);पीडा दिनु;कष्ट पुर्‍याउनु;यन्त्रणा दिनु;यातना दिनु;सताउनु	-1
toying	यौन आकर्षण उत्पन्न गराउन गरिने चंचले ब्यवहार;मस्ती गर्दै	1
traducement	मिथ्या आरोप;गलत आरोप लगाउनु;कसैको भनाइ को गलत अर्थ लगाउनु	-1
transcendent	उत्कृष्ट;अलौकिक	1
trashy	नराम्ररो गुणस्तरको	-1
trick	चलाखी;युक्ती;तनिक (f);तरकीब (f);दाँवी (m);हातको सफाई (f);धोका (m);अनौठो बानी;पारी (f);छलकपट गर्नु;मक्कारी (f);विचित्र बानी;मज़ाक (m);हातको सफाई;चाल (f);चालाकी (f);योजना (f);छल (m);व्याज;छलकपट (m);शरारत (f);जादू (m);धोका दिनु;चकमा दिनु;बहकाउनु;छलकपट गर्नु;ठग्नु;नाजुक;कठिन;कपटपूर्ण;मायावी	-1
troublesome	दु:ख दिने;समस्यामा पार्ने	-1
trustiness	विश्वास गर्न सकिने	1
trustworthiness	विश्वासनीयता;भरोसा र विश्वासता को विशेषता भएको	1
trying	कोशीश गर्दै	-1
tumescent	सुन्निएको;फुलेको	-1
twinge	बटार्नु;सुतली;चुटकी (f);पीडा (m);पीडाको लहर;आवेश;कड्कनु;मोड्नु;पीडा हुनु;चिमोट्नु	-1
ugliness	कुरुपता;बेरुपी	-1
ugly	कुरुप;नराम्रो;खराब;भद्दा;भयंकर;संकटमय;द्वेषपक्ष;खतरनाक;फोहोरी;घृणित;डरलाग्दो;दुष्ट;कुरूप;भयानक	-1
unable	असमर्थ;अयोग्य;अक्षम;अयोग्य;अशक्त;असमर्थ;मंदबुद्धि	-1
unadjusted	समायोजन नगरिएको;मिलाउन बाकी	-1
unanswered	अनुत्तरित;जवाफ नआएको	-1
unbearable	सहन नसकिने;सहन गर्न नहुने;असहनीय;असह्य	-1
unbecoming	अयोग्य;दक्षता नभएको	-1
unblemished	कुनै प्रकारको क्षती नभएको	1
unbound	आवद्ध नभएको	-1
unbridled	छाडा;मनपरी गर्ने	-1
uncivil	असभ्य;रुखो	1
unclassified	अवर्गिक्रित	-1
unclean	मैला;अशुद्ध	-1
uncomfortable	बिना आराम;बेचेन;तकलीफदेह;अप्रिय;असुखद;असुविधाजनक;कष्टप्रद	-1
undependable	भरोसा गर्न नसकिने;विश्वाश गर्न नसकिने	-1
underdog	हेला गरिएको मान्छे;विवश	-1
undress	लुगा फुकाल्नु	1
unemployed	वेरोजगार;वेकार;काम नभएको;बसेको;निरुद्यम;बेकार;बेरोजगार	-1
unemployment	वेरोजगारी;काम नपाएको अवस्था;बेरोजगारी (f);अनुद्योग;बेकार (f)	-1
unexampled	अनौठो;तुलना गर्न नसकिने	-1
unexpired	अवधी समाप्त हुन बाँकी	-1
unfamiliar	अपरीचित;अनुभव नभएको;अज्ञात;अप्रसिद्ध;अनभिज्ञ;अनौठो;अपरिचित;असामान्य;अनजान	-1
unfashionable	फेशन मा नभएको;नचलेको;अप्रचलित	-1
unfavourable	अनुकुल नभएको;प्रतीकुल	-1
unfinished	समाप्त नपारिएको;अपूर्ण	-1
unfortunate	अभागी;पीडित;अभागी;अमंगल;अशुभ;खेदजनक;दुःखद;बेनसीब;हतभाग्य;दुर्भाग्यपूर्ण;बदकिस्मत	-1
unframed	फ्रेम नभएको चित्र वा फोटो	-1
unfriendly	अननुकूल;अमित्रवत;अस्नेही;प्रतिकूल;रूखो;विमुख;अमित्र;अमित्रतापूर्ण;विद्वेशपूर्ण	-1
ungracious	असभ्य;निच;तल्लो स्तरको	1
unhappiness	दु:ख;कष्ट;उदासिनता;खेद (m);दुःख (m);बदकिस्मती;अप्रसन्नता;अभाग्य	-1
unhappy	असन्तुष्ट;दुखि;उदाश;अनुचित;अनुपयुक्त;अप्रसन्न;अभागी;असुखी;चिन्तित;दुःखी;दुखी;बेचारा;मन्दभाग्य;हतभाग्य;दूर्भाग्यपूर्ण;बदकिस्मत	-1
unleaded	सिसा बिनाको	-1
unmarried	विवाह नगरेको	-1
unmistakable	अरु हो भनेर नझुक्किने;धेरै भिन्न;अचूक;असन्दिग्ध;ठीक;सुस्पष्ट	1
unnatural	अस्वभाविक;असामान्य;अप्राकृतिक;असहज;अस्वाभाविक;कृत्रिम;बनावटी;घिनाउनी;स्वभाव विरुद्ध	-1
unofficial	अनौपचारिक;गैरसरकारी	-1
unpalatable	नमिठो;चाख्दा मिठो नलाग्ने	-1
unpardonable	माफि दिन नसकिने	-1
unprovoked	अकारण;अनुत्तेजित;अनिमित्त	-1
unregenerate	नैतीक सोच वा जागरण नभएको	-1
unreliable	अविश्वसनीय;भर पर्न नसक्ने	-1
unrighteousness	नैतीक सिद्धान्त को पालना गर्न चुकेको	1
unsatisfied	असन्तुष्ट	-1
unscheduled	तालिका मा नतोकिएको;कुनै टुङगो नभएको	-1
unsocial	अमिल्दो;असामाजिक	-1
unsung	नाम किर्ती लोकप्रियता नभएको	-1
unthinkable	सोच्न वा विचार गर्न नसकिने;अचिन्त्य;अशोचनीय;असम्भव;असोच;कल्पनातीत;जस्को कल्पना नगरिएको;अकल्पनीय	-1
untoward	अशुभ	-1
untrue	असत्य;झुटो	-1
unusable	बेकार;कामनलाग्ने	-1
unwell	रोगी;विरामी;अस्वस्थ	-1
unwilling	अनिच्छुक;मनमरेको	-1
unworkable	काम चलाऊन नसकिने	-1
unwrinkled	नखुम्चिएको;मिलेको (कपडा वा छाला)	-1
upbeat	सुखी;प्रसन्न	1
upset	उदास;अस्तव्यस्तता (m);गडबड (m);गडबडी (f);हैरान गर्दिनु;डराउनु;हैरान;पलट;विपर्यय (m);डराई दिनु;हैरान गर्नु;उल्टनु;उल्टाई दिनु;खराब गर्नु;औंधाना;पल्टाई दिनु;तल माथि गर्नु;गडबड गर्दिनु;डराउनु;हैरान गर्दिनु;उल्टो;निर्दिष्ट;निश्चल	-1
urbanity	सभ्यता	1
urchin	दुष्ट वा बदमास बच्चा	-1
urethritis	पिशाव को नली सुन्निनु	-1
usurious	अत्यधिक उच्च ब्याज दरमा पैशा लेनदेन गर्ने सम्बन्धी	-1
valiant	बहादुर;साहसी	1
valorous	प्रराक्रमी;शुरविर	1
venal	घुस खाने;धनको लोभि	1
venerate	पूजा गर्नु;आदर गर्नु	1
veracious	सत्य बोल्ने;ठीक	1
verisimilitude	भ्रम;साचोजस्तो देखिने	1
vertiginous	रिङ्गटा लगाउने	-1
vibrant	गुन्जने;काप्ने;उद्योगी;कम्पमान;गुञ्जायमान;चम्किलो;फुर्तीलो;व्यवसायिक;जोशपूर्ण;चम्कीले और आकर्षक	1
vicious	निच;भयानक;नराम्रो;भ्रष्ट;सदोष;सरकश;क्रूरतापूर्ण;दू;विद्वेषपूर्ण;अनैतिक;शातिर;खराब;खोटो;दुष्ट;दोषी;निन्दनीय;पतित;पापमय;पापी	-1
virtuoso	कलाको पारखी	1
virtuous	सदाचारी;चरित्रशिल	1
vivacious	सजिव;सकृय	1
voluptuary	विलासी;भोगी	1
waggish	रसिक;हासखेल गर्नु पर्ने	1
wail	रुनु कराउनु;उच्च आवाजमा रूनु;आवाज (f);विलाप (m);चिच्याउनु;शोक गर्नु;विलाप गर्नु;आवाज गर्नु;दुखद रूनु;उच्च आवाजमा रूनु;चिच्याउनु;चिन्ता गर्नु;रूनु;विलाप गर्नु	-1
wanting	गुण र परीमाणमा न्युनता	-1
washable	धुनयोग्य;सफा गर्न योग्य	1
wearying	थकित बनाउने;थकाउने	-1
weep	रुनु;टपक्नु;बग्नु;रूनु;निन्दा गर्नु;विलाप गर्नु;गुनासो गर्नु;आँसू झार्नु	-1
well	स्वस्थ्य;सन्चो;इनार;झरना (m);स्रोत (m);राम्रोले;हित;तेलको कुवा;कुवा;कूपक (m);बावडी (f);फाइदा;निकाल्नु;उमार्नु;बग्नु;ठीक;निरोग;राम्रो;भग्यवान;अनुकूल;सुन्दर;कुशल;सुरक्षित;राम्रोले;धेरै;बखूबी;धेरै ज्यादा;लगभग;पूर्ण रूपले;पूरा तरिकाले;शायद;उचित रूपले;सही;भली भान्ति;सहज नै	1
well-being	कल्याण (m);तन्दुरुस्ती (f);भलाई;शुभ;श्रेय;सुख (m);सेहत;स्वास्थ्य;हित	1
winning	विजयी;जित्ने	1
winsome	मोह पार्ने;आकर्षक	1
woeful	शोकाकुल;दुखी	-1
woefully	दुर्भाग्य पूर्ण ढंगले	-1
won	जित	-1
wonder	छक्क पार्नु;अचम्म मान्नु;अद्भुत वस्तु (m);अचम्म (m);अचरज (m);अद्भुत दृश्य (m);आश्चर्य (m);चमत्कार (m);ताज्जुब (m);विस्मय (m);करामाती (m);विस्मित हुनु;आश्चर्य हुनु;अचम्भित हुनु;चकित हुनु;जान्नेको उत्सुक हुनु;सन्देह हुनु;जान्नको लागि उत्सुक हुनु;ताजुब्ब गर्नु;अचम्भमा पड्नु;सन्देह गर्नु;आश्चर्य गर्नु	1
wonderful	औधी राम्रो;अनौठो;अत्युत्तम;अद्भुत;अनौठो;आश्चर्यजनक;एकान्त र निर्जन;प्रशंसनीय;चमत्कारिक;धेरै ठूलो	1
wonderment	आश्चर्य;विस्मय	1
wondrous	अनौठो;नौलो	1
woozy	अस्थिर;ढल्न लागेको;हल्लिने;स्थिर नभएको	-1
wordiness	शब्दजाल;शब्दहरुको अनर्थक	-1
worried	चिन्तित;चिन्ताग्रस्त;चिन्तित;व्याकुल	-1
worrying	चिन्ता गर्दै;हल्लाउनु;सताउनु;चिन्ताजनक	-1
worshipful	पुज्य;पूजनिय	1
worst	सबै भन्दा नराम्रो चिज;सर्वाधिक खराब;सबैभन्दा रद्दी;सबैभन्दा नराम्रो;दुष्टतम;सबैभन्दा बढी नोक्सानी;निकृष्टतम;सबैभन्दा नराम्रो कुरा;तराम्रो तरिकाले पछाडि पार्नु;जित्नु;हार्नु;पराजित गर्नु;सर्वाधिक नराम्रो;सभैभन्दा रद्दी;सबैभन्दा खराब;सबैभन्दा बेकार;सबैभन्दा खराब	-1
worthy	मुल्यवान;ठीक;गुणवान पुरुष;योग्य मानिस;माननीय व्यक्ति;विलक्षण व्यक्ति;सम्माननीय व्यक्ति;योग्य;लायक;समान;सुयोग्य;इज्जतदार;हकदार;आदरणीय;ईमानदार;उपयुक्त;सक्षम;महत्त्वपुर्ण;गुणवान;पूज्य;बहुमूल्य	1
wrong	गलत;बेठिक;अन्याय (m);पाप (m);भूल (f);गलत दोष लगाउनु;हानि (f);उपकार;गैर कानूनी;गुनाह (m);जुल्म (m);नाइन्साफी (f);अन्याय गर्नु;गलत दोष लगाउनु;गलत बर्ताव गर्नु;अनुचित रूपले बदनाम गर्नु;हानि पुर्‍याउनु;गलत समझ्नु;अन्यायपूर्ण;नराम्रो;अपकार;अशुद्ध;गलत;उल्टो;गैर कानूनी;उल्टो;खराब;खराबी;प्रतिकुल;गडबड;गलत;अनुचित;अनुपयुक्त;झूटो;अनैतिक;दोष;गलत ढंगले;गडबड ढंगले;भूलले;गलतीले	-1
wrongful	अवैध;अनुचित	-1
xenophobic	वेदेशीहरुप्रतीको घ्रिणा भाव;भय या डर भएको;अज्ञातजनभीत;अज्ञातजन भीरू	-1
yob	अभद्र;हल्ला गर्ने र आक्रामक स्वभाव भएको जवान केटो;गुण्डा (m);धौसिया	-1
yokel	गाउको मानिस;गॅँवार;देहाती (m)	-1